JustEase	{'category': '', 'description': 'JustEase is a crowdfunding platform designed specifically for legal case.', 'tags': 'Crowdfunding, Legal, Legal Tech, Online Portals'}
Functional Imperative	{'category': '', 'description': 'Functional Imperative is a boutique software development firm that works in the legal space.  We work with in-house counsel, law firms, and legaltech companies to build highly targeted solutions.  '}
Stanford Securities Litigation Analytics	{'category': '', 'description': 'Explore a database of over 2700 federal securities class actions filed since January 1, 2000. Read the specifics of a particular case, or query the entire database across over 40 filters with aggregate statistics and interactive data visualizations as the result.'}
VisiRule	{'category': '', 'description': 'VisiRule is a graphical tool for non-programmers to develop and deliver rule-based and expert systems simply by drawing their decision logic.'}
BitTitan	{'category': '', 'description': 'BitTitan revolutionizes cloud services enablement and managed services automation, delivering solutions that empower service providers to sell, onboard, and service cloud technology.  BitTitan® empowers IT services professionals to properly assess, deploy, and manage technology solutions in a cloud-first world. With BitTitan MSPComplete®, an IT services automation platform featuring BitTitan’s globally renowned MigrationWiz® solution, IT professionals can organize, optimize, and automate service delivery. '}
Coherent Knowledge	{'category': '', 'description': 'Coherent Knowledge was created to deliver the benefits of recent breakthrough research in logical, linguistic, and semantic technologies to markets that need to incorporate larger amounts of increasingly dynamic knowledge in systems that reliably and robustly answer questions, support decisions, and comply with governing doctrine.'}
Riverview Law	{'category': '', 'description': 'Riverview Law, an innovative legal services firm.', 'tags': 'Advice, Information Technology, Legal, Legal Tech, Software'}
TrustedHeir	{'category': '', 'description': 'TrustedHeir is the secure, revenue-generating application for estate planners that automates the process of managing digital assets.  TrustedHeir is designed to automate the process of organizing your client’s digital assets, keeping their login information up-to-date and managing the execution of the digital estate upon your client’s passing.', 'tags': 'estate planning'}
elementaryIP	{'category': '', 'description': 'Deep learning AI for patent search and analytics'}
Xcential Legislative Technologies	{'category': '', 'description': 'Xcential provides SaaS-based solutions enable legislatures and regulatory to more efficiently create/publish legislation and regulations.'}
Directive Communication Systems, Inc.	{'category': '', 'description': 'Technology has made lives easier, however, for trusts and estates it has created a growing $7 trillion problem. More specifically, for estate professionals website owners and government agencies, it poses new and significant challenges to existing practice and protocols. The average person now has over 130 accounts including financial, social media, email, cloud based storage, eCommerce, cryptocurrency and many more. With so many accounts and no real way to capture our online footprint, it’s easy for digital property and information to be hidden, lost or forgotten.\xa0 Unlike tangible assets, digital property can not simply be accessed for review or passed on to heirs. Legal professionals and loved ones face a large and intricate maze of privacy policies, account holder agreements (TOSA) and governmental statutes designed to protect account holder privacy.\xa0Between digital assets, statutory and contractual mandates, and the sheer volume of accounts, the industry needs a solution now.   \xa0 Directive Communication Systems, (DCS), where technology meets the outdated world of Trusts and Estates. DCS is the first and only technology based solution streamlining and networking digital asset and online account directives management. DCS provides an easy use to platform for identifying, organizing and cataloging all types of digital assets in preparation for estate affairs. DCS facilitates the process for ALL stakeholders with a platform that captures an individual’s accounts and directives now and into the future, making the service invaluable to clients for their lifetime. DCS simplifies estate administration by handling the communication of final wishes to site owners. In addition to NOT taking account passwords nor knowing the contents of an account, DCS is compliant to site owner Terms of Service Agreements and existing statutes, reducing costs and frustration. For website owners, DCS delivers improved efficiency for account holder death process management with streamlined notifications and online options administration. Ultimately, DCS will deliver a complete data communication network connecting all stakeholders including website owners, estates and government, speeding up a several month process to mere minutes.  ', 'tags': 'rufadaa, estate planning, digital assets, trusts & estates, estate planning, trusts'}
Class Action App	{'category': '', 'description': 'Automated class-action claims processor, including eligibility determination, filing, monitoring, and claims payment.'}
Cognate	{'category': '', 'description': 'New way to record and prove trademark use.'}
SirionLabs	{'category': '', 'description': 'Post-signature contract management platform'}
smartwork solutions GmbH	{'category': '', 'description': 'SMASHDOCs is a web-based word processor that makes it extremely easy and fast to create, revise and negotiate legal documents.  Smart version control Instead of creating countless versions of a document, SMASHDOCs saves all proposed changes, decisions and comments paragraph-by-paragraph in just one single document. Version chaos is now a thing of the past – finally.  Smart redlining SMASHDOCs knows which changes and comments are new to a user and automatically highlights them for him - even when multiple users are editing a document simultaneously. Cumbersome version comparisons are no longer necessary.  Smart Word integration Send out a Word document if some people don’t work with SMASHDOCs.  If you get a new Word version from them, simply re-import it into your SMASHDOCs document and save the changes.  Smart reporting Do a contract review within seconds by comparing any number of documents and creating a synopsis report showing changes to every paragraph.', 'tags': 'negotiation, word processing, document collaboration'}
WibniLabs	{'category': '', 'description': 'WibniLabs helps service-focused organizations use design thinking to cost-effectively capture, conceptualize and carry out innovative ideas.'}
Vonzella	{'category': '', 'description': 'Vonzella offers a high-quality directory service connecting those that have been accused of crimes (and their support networks) with Vonzella Approved service providers that can help post bail. We also offer an evolving Help Desk solution to answer common questions about the bail process. We vet the bail process so that you don’t have to. We are constantly researching and striving to build new and better products that support our communities’ right to remain free. For as long as there is a commercial bail system in the United States, we pledge to make it transparent and fairer for everyone.'}
Vakilsearch	{'category': '', 'description': 'Vakilsearch operates an online professional services platform for lawyers, corporate bodies, and professionals in India.', 'tags': 'Information Technology, Internet, Legal, Legal Tech, Software'}
Unified Patents	{'category': '', 'description': 'Unified employs a multi-faceted solution to deter abusive patent assertions.', 'tags': 'Information Technology, Intellectual Property, Legal, Legal Tech'}
Uabide	{'category': '', 'description': 'Uabide provides identity management.', 'tags': 'Consulting, E-Commerce, Information Technology, Legal, Legal Tech, Online Portals'}
Trail Bloom	{'category': '', 'description': 'Maker of the Trial Boom courtroom simulator for attorneys & students.'}
DeLeyes	{'category': '', 'description': 'Lo legal hecho simple'}
TechGC	{'category': '', 'description': 'TechGC is a platform for General Counsels of leading venture capital funds and high growth technology companies.', 'tags': 'Consulting, Finance, Information Technology, Legal, Legal Tech'}
Statera	{'category': '', 'description': '[acquired in 2013] Kick-starter for lawyers defending massive environmental damage cases'}
Contraktor	{'category': '', 'description': 'Electronic signature, control of deadlines and maturities for management of high performance contracts.'}
eVue Digital Labs	{'category': '', 'description': 'Harmonizing the physical with the digital to bring the world virtual. Including forensics.'}
IntelliLaw	{'category': '', 'description': 'Funds documents management and business services'}
LawGuage.com	{'category': '', 'description': 'LawGuage is a discussion forum for free legal procedures, finance, government schemes, business, and tax advice.', 'tags': 'Advice, Consulting, Legal, Legal Tech'}
eEvidence	{'category': '', 'description': 'eEvidence offers a free service to legally certify an email, its content, and its eventual delivery to third parties.', 'tags': 'Email, Legal, Legal Tech'}
ShieldMyfiles	{'category': '', 'description': 'Better File Security'}
Casefunder	{'category': '', 'description': 'Crowdfunding legal costs.'}
Legal Creatives	{'category': '', 'description': 'Legal Creatives consults and trains legal entrepreneurs.', 'tags': 'Continuing Education, Events, Legal, Legal Tech'}
Privatim	{'category': '', 'description': 'Secure. Client. Communication.'}
GLC CONSULTORES	{'category': '', 'description': 'Legal Services for Entrepreneurs'}
Lexa	{'category': '', 'description': 'Uber for Lawyers'}
Netcog	{'category': '', 'description': 'Netcog is a privately-held company that designs, develops and deploys web-based applications for a select group of private clients.', 'tags': 'Information Technology, Internet, Legal, Legal Tech, Software'}
LegalBods	{'category': '', 'description': 'Real world feedback for lawyers'}
Courtsdesk	{'category': '', 'description': 'Courtdesk provides online database of court cases and reporting in Ireland.', 'tags': 'Data Integration, Law Enforcement, Legal, Legal Tech, News'}
Courtroom5	{'category': '', 'description': 'Courtroom5 delivers access to justice to people in civil court without a lawyer.', 'tags': 'Consulting, Legal, Legal Tech, Software'}
SOLOMON Justice AI	{'category': '', 'description': 'Law Enforcement Software'}
Legal Innovation Paris	{'category': '', 'description': 'The collective Legal Innovation Paris was created in 2012 by teachers and students of the Computer Science and Law.', 'tags': 'Consulting, Information Technology, Legal, Legal Tech, Software'}
IP Metro	{'category': '', 'description': 'IP Metro offers a range of online tools.', 'tags': 'Consulting, Information Technology, Legal, Legal Tech, Software'}
Rightz	{'category': '', 'description': 'Siri for legal topics (Rightz).'}
Threat Resilience	{'category': '', 'description': 'Next Generation MSSP'}
RovBOT	{'category': '', 'description': 'RovBOT is a tool to help international students with their Canadian visa process.', 'tags': 'Artificial Intelligence, Legal, Legal Tech, Software'}
soocasa	{'category': '', 'description': 'Real Estate Lease Option Platform'}
Someturva	{'category': '', 'description': 'Someturva offers free legal help for users of social media and other online platforms.', 'tags': 'Artificial Intelligence, Legal, Legal Tech, Social Assistance, Software'}
moviinn	{'category': '', 'description': 'Relocation made simple'}
Civil Informer	{'category': '', 'description': 'Level the Legal Industry with Artificial Intelligence'}
Pax	{'category': '', 'description': 'Pax is a civic network and peer to peer legal system powered by Ethereum.'}
About innovation	{'category': '', 'description': 'About innovation is an intangible asset management software. Our solution allows you to identify, protect and exploit your intangible assets to develop your business. Several services are included such as:  - company data import  - IP dashboard (to visualize all IP titles) - Document generator  - Electronic signature', 'tags': 'intellectual property, legal tech'}
Flex Legal	{'category': '', 'description': 'Flexible resourcing for Law Firms'}
High Performance Counsel	{'category': '', 'description': 'We feature the individuals, organizations & solutions driving the next decade of leadership & innovation in law. '}
NEXAW	{'category': '', 'description': 'Coming Soon NEXAW â\x84¢ The Start Up Legal Company'}
Online patent, LLC 	{'category': '', 'description': 'Online Patent is one of the market leaders in Russian intellectual property market, TOP-5 in the trademark registration segment. Since 2014 we have been developing the IT-platform for intellectual property management, that allows to completely automate most of the typical patent attorney actions. The company has strong competencies in the field of Data Analysis and Business Process Automation.  Our main product - international IT-platform for intellectual property rights management, which allows to make all actions with your patents and trademarks in 1-Click. Globally, our services are used by such companies as COFCO, FAW and Deloitte. With Online Patent, you can consolidate and simply manage all your previously registered trademarks, patents, and, also, applications that are currently being analyzed by Patent Offices in various countries. The functionality of platform includes, for example, filing of new applications, renewing of registrations and managing of IP holders.', 'tags': 'digital platform'}
Beacon Direct Cremation	{'category': '', 'description': 'Beacon Direct Cremation is a family-owned direct cremation services offered in Tampa bay, Florida. Offering a simple and affordable alternative to traditional funeral home experience. We ensures no lies, no hidden fees, and complete transparency from the start of our conversation through the completion of the cremation arrangement process. ', 'tags': 'cremation services, direct cremation services'}
AJC Asesor fiscal y contable en Madrid	{'category': '', 'description': 'Economista asesor fiscal, presta servicios de asesoramiento fiscal y presentación de impuestos a empresas, autónomos y particulares', 'tags': 'asesoria fiscal'}
Fucitech.com	{'category': '', 'description': 'We are starting our quest for general artificial intelligence by designing a model that will help in-house lawyers assess risk. Our proprietary software (still in development) structures all legal information on the federal level and ties it to unique risk factors of our clients. This empowers in-house attorneys to see issues quicker or that were once hidden and expands their knowledge base to address these issues by giving them transparent and well structured access to the rules that govern their clients actions. We seek to empower the generalist to dive deeper into any practice area quickly and effectively so they can reduce their reliance on outside sources and craft unique solutions.', 'tags': 'nlp'}
Blika Solutions AB	{'category': '', 'description': 'The Blika platform is the starting point for the digitalization of the legal department and will help you to collect various types of data in a structured process. The solution is developed in modules which means that you can start with the modules you currently need and scale up at a later date by easily switching on additional modules.   All modules are integrated and information is therefore available where it is needed and you avoid double entry of data. In addition, you will be able to automate manual work when working in an integrated one system solution.   Many times several departments use the same base information, e.g. legal entity information and ownership structure, which makes it possible to increase efficiency by having several departments work in the solution (and share the cost). Each department will be able to view and work only with the information they need in their own modules, i.e. each department will not see the other departments data. However, data which is needed in their respective process will be retrieved from other modules where it is available in order to avoid double work and increase quality and efficiency.', 'tags': 'legal operations solution'}
Neu Skin	{'category': '', 'description': 'NEU Skin International Limited has been well-established since 2012, cooperated with over 50 manufacturers and R&D internationally for high-end professional skincare & beauty products. NEU Skin has been striving to explore and provide the safest, the most effective and the highest quality products. NEU Skin is collaborating with one of the innovative cosmetologist from Korea – Dr. Song, for the world-wide exclusive products and the latest effective brands REIZ.', 'tags': 'collagen eye mask, hyaluronic acid serum for skin, skin tightening, skin whitening serum, anti-wrinkles, moisturizing serum, anti-aging serum, moisture serum, skin care products, anti-aging skincare'}
Certifix Live Scan	{'category': '', 'description': 'Livescan service provider authorized by FBI & DOJ', 'tags': 'employee background check, live scan fingerprinting'}
Danse Orientale 5€	{'category': '', 'description': "Kreadance est une association de danse basée sur Paris 13 et en région parisienne (94 et 95). Kreadance propose des cours de danse au prix très avantageux, soit 5€ le cours. Des cours de danse orientale de haute qualité enseignés par des professeures expérimentées et passionnées de la danse.  Chaque cours repose sur une thématique différente. On peut être amené à travailler avec des accessoires liés à la danse orientale comme les sagattes, le voile ou encore la canne. On peut aussi travailler sur d'autres types de thématiques : la fluidité et la grâce des mouvements, le saccadé des mouvements, les transitions, l'improvisation, création de chorégraphie, travail des enchaînements... Des stages avancés et des ateliers de danse orientale pour enfants sont aussi organisés tout au long de l'année. Les cours de danse orientale ont lieu dans une ambiance conviviale et studieuse. A la fin de chaque cours nous proposons une dégustation de thé, une dégustation de gâteaux orientaux ou encore des jus frais healthy fait maison. Venez apprendre ou vous perfectionner en danse orientale dans un jolie studio spacieux, avec un parquet impeccable, de très grands miroirs, une bonne sono, et une climatisation pour les temps de chaleur. Enfin le studio propose un agréable espace détente comprenant un bar, des canapés et des tables. Le studio propose aussi des vestiaires pour celles qui veulent se changer avant le cours. A chaque cours il est possible de ramener un foulard ou une ceinture de danse orientale. Concernant la tenue, il est conseillé de porter des vêtements dans lesquels vous serez à l'aise pour danse. Nous vous conseillons un legging pour le bas et un débardeur ou tee-shirt pour le haut. La danse orientale se danse de préférence pieds nus ou en chaussette ! Pour celles qui veulent, vous pouvez très bien prendre avec vous une paire de chausson de danse classique. ", 'tags': 'apprendre à danser oriental, cours de danse orientale, danse orientale'}
KISSPatent	{'category': '', 'description': 'At KISSPatent, our goal is to make patent protection accessible to everyone - even those with fewer resources, like startups. We are already supporting clients through our global patent platform. We help clients from all over the world obtain patent protection internationally. We encourage our clients to obtain patent protection in any and all countries where they may want to do business – and to dream big. ', 'tags': 'innovation, artificial intelligence, blockchain, legal tech, law'}
Citadel Law Firm PLLC	{'category': '', 'description': 'Citadel is an Arizona-based law firm serving clients in Estate Planning, Wills and Trusts, Probate, and Tax Law. We primarily serve Chandler, Gilbert, Mesa, and the East Valley.'}
AxiomaVox	{'category': '', 'description': "We are an independent research firm in Paris that works in the intersection of computational logic, category theory, and persistent topology applied to decision practices. Our approach comprises an efficient model to generate belief structure about differing cases that have 'uncertain' information. The direction accompanies a method for realizing a complex means to address various constraints that arise in discourse analysis related to law. This implies a strong connection with natural language processing and the determining of a graphical realization, in lieu of an algorithmic method for identifying semantic change."}
Digital DNA Group	{'category': '', 'description': 'The Digital DNA Group was formed by an elite team of cybersecurity and forensics experts.  The Digital DNA Group is shaping the future of digital forensics with an integrated platform that combines forensic data collection, collaboration and an advanced case management platform. Our product, Rocket Cloud, allows you to create Forensics-as-a-Service (FaaS) for your business.   ', 'tags': '#forensics #investigations #e-discovery #forensiccollection #collections'}
Bodhala	{'category': '', 'description': 'Bodhala is a SaaS platform that empowers in-house legal teams to better analyze, interpret and optimize outside counsel spending.', 'tags': 'Information Services, Information Technology, Legal Tech, SaaS'}
UpCounsel	{'category': '', 'description': 'UpCounsel operates an online marketplace for businesses to find and hire legal help based on their preferences in the United States.', 'tags': 'B2B, Information Technology, Legal, Legal Tech, Marketplace'}
OneDome	{'category': '', 'description': 'OneDome is the First Managed Property Marketplace', 'tags': 'Classifieds, Legal Tech, Marketplace, Real Estate'}
Mighty	{'category': '', 'description': 'Mighty is a online business platform designed to find plaintiffs for the justice system.', 'tags': 'Legal Tech, SaaS, Software'}
BRYTER	{'category': '', 'description': 'BRYTER is the leading no-code building platform to automate expert knowledge.', 'tags': 'Enterprise Software, Industrial Automation, Legal Tech, SaaS, Software'}
XCLAIM	{'category': '', 'description': 'XCLAIM revolutionizes the bankruptcy claims market by introducing digital efficiencies of scale.', 'tags': 'B2B, Enterprise, Financial Exchanges, Financial Services, FinTech, Legal Tech, Marketplace'}
Legalpad	{'category': '', 'description': 'Legalpad makes work visa applications faster, easier, and better for startups.', 'tags': 'Information Technology, Legal, Legal Tech'}
Plunes	{'category': '', 'description': 'Plunes is the most economical online/offline consultation platform.', 'tags': 'Consulting, Information Technology, Legal, Legal Tech, Software'}
Leverton	{'category': '', 'description': 'Leverton is AI-powered data extraction and contract analytics platform.', 'tags': 'Artificial Intelligence, Enterprise Software, InsurTech, Intelligent Systems, Legal Tech, Machine Learning, Natural Language Processing, SaaS, Software'}
Usercentrics	{'category': '', 'description': 'Usercentrics is a CCPA and GDPR Consent Management Solution for Enterprises.', 'tags': 'Cyber Security, Digital Marketing, Identity Management, Internet, Legal, Legal Tech, Marketing Automation, Privacy, SaaS, Software'}
Cortical.io	{'category': '', 'description': 'Cortical.io’s offers AI-based natural language understanding solutions built on technology inspired by Neuroscience', 'tags': 'Artificial Intelligence, Big Data, Enterprise Software, Information Technology, Legal Tech, Machine Learning, Natural Language Processing, Semantic Search, Software'}
Brightflag	{'category': '', 'description': 'Brightflag is the enterprise legal management (ELM) platform for corporate legal teams.', 'tags': 'Enterprise Software, Legal, Legal Tech, SaaS, Software'}
LegalMation	{'category': '', 'description': 'LegalMation is an AI technology company that provides tools to help attorneys and legal professionals automate routine litigation tasks.', 'tags': 'Artificial Intelligence, Information Technology, Legal, Legal Tech, Software'}
Wundertax	{'category': '', 'description': 'Wundertax provides online tax returns filing and related services.', 'tags': 'Financial Services, Internet, Legal, Legal Tech'}
Smart Protection	{'category': '', 'description': 'Smart Protection keeps and protects intellectual and industrial property rights online.', 'tags': 'Customer Service, Cyber Security, Intellectual Property, Legal, Legal Tech, SaaS, Security, Software'}
The Link App	{'category': '', 'description': 'The Link App is an easy-to-use platform that reinvents a law firm’s client experience.', 'tags': 'Apps, Computer, Customer Service, Legal, Legal Tech, Software'}
Privacy Tools	{'category': '', 'description': 'Privacy compliance platform, based on AI/Blockchain, which helps global companies to keep compliant with the data protection requirements.', 'tags': 'Compliance, Cyber Security, Information Technology, Legal, Legal Tech, Network Security, Privacy, Software'}
Sigalei	{'category': '', 'description': 'Sigalei uses legislative data, technology, and legal knowledge and government relations to develop technology.', 'tags': 'Artificial Intelligence, Government, GovTech, Legal, Legal Tech'}
LitiGate	{'category': '', 'description': 'AI-Powered Litigation Platform', 'tags': 'Artificial Intelligence, InsurTech, Legal, Legal Tech, Machine Learning, Text Analytics'}
Vauban	{'category': '', 'description': 'Wealth Container Platform', 'tags': 'Financial Services, FinTech, Information Technology, Legal, Legal Tech'}
Clara	{'category': '', 'description': 'Your legal command centre: execute agreements, manage your stakeholders, and make more informed decisions, all from a single platform.', 'tags': 'Legal, Legal Tech, Venture Capital'}
Validated ID	{'category': '', 'description': 'Validated ID helps businesses bring security, trust, efficiency and legal compliance to customer identity verification and agreements.', 'tags': 'Blockchain, E-Signature, Identity Management, Information Technology, Legal Tech, Productivity Tools, SaaS, Security'}
Parley Pro	{'category': '', 'description': 'Parley Pro is a modern contract lifecycle management platform that helps companies create, negotiate and manage smarter contracts faster.', 'tags': 'B2B, Contact Management, Document Management, Legal Tech, SaaS, Software'}
LegitQuest	{'category': '', 'description': 'LegitQuest is a legal-tech company that operates a legal research platform with Indian case laws.', 'tags': 'Legal, Legal Tech, Search Engine'}
Legalkart	{'category': '', 'description': 'LegalKart is a simple, convenient location to share files, communicate, and collaborate with your clients.', 'tags': 'Legal, Legal Tech'}
Reynen Court	{'category': '', 'description': 'Service Automation platform for Law Firms', 'tags': 'Artificial Intelligence, Legal Tech'}
SINAI	{'category': '', 'description': 'SINAI develops enterprise software for automating the regulatory burden of managing carbon taxes and climate risk.', 'tags': 'Enterprise Software, Legal, Legal Tech'}
Orbital Witness	{'category': '', 'description': 'Orbital Witness aggregates geospatial, property, and legal data from diverse sources to provide an unprecedented view of legal risk..', 'tags': 'Consulting, Information Services, Legal, Legal Tech, Real Estate'}
Thirdfort	{'category': '', 'description': 'Verifying client ID and source of funds in minutes. We are trusted by award winning conveyancers around the UK.', 'tags': 'FinTech, Information Technology, Legal, Legal Tech, Transaction Processing'}
AppClose, Inc	{'category': '', 'description': 'The #1 FREE Co-Parenting App.', 'tags': 'Apps, Legal, Legal Tech'}
Clairvolex	{'category': '', 'description': 'Clairvolex is an IP solutions company that manages IP assets of large corporations using an IPAM model.', 'tags': 'Legal, Legal Tech'}
ClaimKit	{'category': '', 'description': 'ClaimKit is a data collection and review guru for the insurance and legal industries.', 'tags': 'Construction, Document Management, Information Services, Legal, Legal Tech, Professional Services'}
CryptoTax	{'category': '', 'description': 'Tax reporting and compliance solutions for all digital assets.', 'tags': 'Cryptocurrency, Financial Services, Information Technology, Legal Tech, SaaS, Software'}
LZVCPA	{'category': '', 'description': 'LZVCPA is a CPA firm that provides financial, audit, tax, IT and legal services.', 'tags': 'Accounting, Blockchain, Financial Services, Legal Tech'}
Qwill	{'category': '', 'description': 'Estate planning for the cloud generation', 'tags': 'Legal Tech'}
Flightright	{'category': '', 'description': 'Flightright is an air passenger claims management that offers assistance and advisory services.', 'tags': 'Air Transportation, Customer Service, Legal, Legal Tech, Transportation, Travel'}
Matterhorn	{'category': '', 'description': 'Court Innovations, a Software-as-a-Service company, develops an online case resolution platform.', 'tags': 'GovTech, Law Enforcement, Legal, Legal Tech, SaaS, Software'}
AppearMe	{'category': '', 'description': 'AppearMe is a real-time and on-demand web and mobile app that connects thousands of legal professionals within minutes.', 'tags': 'Apps, Legal, Legal Tech, Software'}
ECFX	{'category': '', 'description': 'Intelligent Automation of Electronic Court Notices', 'tags': 'Legal Tech, Software'}
Autologyx	{'category': '', 'description': 'Autologyx is the next-generation Fabric Automation Platform for enterprise businesses.', 'tags': 'Apps, Enterprise Software, Legal, Legal Tech, PaaS, SaaS, Software'}
reclamador.es	{'category': '', 'description': 'reclamador.es offers legaltech and crowd complaining services to help customers claims to companies.', 'tags': 'Consumer, Customer Service, Legal, Legal Tech, Professional Services'}
HETIKUS	{'category': '', 'description': 'We help our customers take control of their GRC strategy by optimizing their workflows, simplifying management and boosting collaboration.', 'tags': 'Consulting, InsurTech, Internet, Legal Tech, Software'}
TrustChain Systems	{'category': '', 'description': 'Secure digital contracting for companies with integrated financial solutions.', 'tags': 'Computer, Financial Services, FinTech, Legal Tech, Wholesale'}
Resolvvi	{'category': '', 'description': 'Resolvvi helps flight passengers receive compensations for flight delays, cancellations, missed connections, and overbookings.', 'tags': 'Advice, B2C, Consulting, Legal, Legal Tech, Logistics'}
Justify	{'category': '', 'description': 'Justify is a legal tech startup.', 'tags': 'Legal, Legal Tech'}
Turn Technologies, Inc.	{'category': '', 'description': 'Turn builds solutions for the 1099 labor supply side of the gig economy.', 'tags': 'Developer APIs, Identity Management, Information Services, Internet, Legal Tech, Mobile Apps, SaaS, Software, Virtual Workforce'}
COPYTRACK	{'category': '', 'description': 'Global Image Search and Copyright Enforcement', 'tags': 'Image Recognition, Intellectual Property, Internet, Legal Tech, Photography'}
helpcheck	{'category': '', 'description': 'helpcheck is a legal tech company from Dusseldorf.', 'tags': 'Internet, Legal Tech'}
Doc2	{'category': '', 'description': 'Document creation automation and eSigning platform for SMEs.', 'tags': 'Information Technology, Internet, Legal Tech, SaaS, Software'}
avvoka	{'category': '', 'description': 'Avvoka enables businesses to automatically generate, track, e-sign, and store their standard-form legal contracts online.', 'tags': 'Analytics, Cloud Computing, Information Services, Legal, Legal Tech, SaaS, Software'}
Focus	{'category': '', 'description': 'Focus is a legal tech startup that developed an algorithm that can rank patents based on their technological importance.', 'tags': 'Legal, Legal Tech'}
HighCastle	{'category': '', 'description': 'HighCastle is a capital raising, securities issuance and shareholder management platform', 'tags': 'Blockchain, Financial Exchanges, Financial Services, FinTech, Funding Platform, Legal Tech, Trading Platform, Venture Capital'}
Recidiviz	{'category': '', 'description': 'Recidiviz develops an extensible platform designed to power data-driven interventions in criminal justice.', 'tags': 'Analytics, Cloud Data Services, Legal, Legal Tech'}
TOPCOURT LTS	{'category': '', 'description': 'TOOCOURT builds products and services to help automate legal workflows, innovate new processes, and help firms identify new clients.', 'tags': 'Legal Tech'}
Ettorney	{'category': '', 'description': 'Ettorney is the leading platform for online legal services in Israel.', 'tags': 'Document Management, Legal, Legal Tech, Online Portals'}
Matter365	{'category': '', 'description': 'SaaS platform helping SMBs to better organize, bill more, and focus on what matters.', 'tags': 'Cloud Computing, Legal Tech, SaaS, Software'}
Zeyo	{'category': '', 'description': 'Zeyo is an online alternative to small claims court that allows users to handle their small claim suit entirely online via video conference.', 'tags': 'Legal Tech'}
Amulex	{'category': '', 'description': 'Amulex offers legal assistance to individuals and corporate clients.', 'tags': 'Legal, Legal Tech'}
MessagePath	{'category': '', 'description': 'The first app to optimize front-line business communications and contracts across all channels.', 'tags': 'Artificial Intelligence, Business Development, Customer Service, Information Technology, Legal, Legal Tech, Messaging'}
Justice.cool	{'category': '', 'description': 'Justice.cool is the first AI driven Mediation Platform', 'tags': 'Artificial Intelligence, Legal, Legal Tech, Payments'}
Legal Utopia	{'category': '', 'description': 'Sass, Mobile App, Legal Services', 'tags': 'Information Technology, Legal, Legal Tech, Software'}
IdeaBlock	{'category': '', 'description': 'IdeaBlock designs and develops a blockchain powered platform that grants intellectual property protection to clients.', 'tags': 'Blockchain, Intellectual Property, Legal Tech'}
Dilecy	{'category': '', 'description': 'B2C Data Protection Tool', 'tags': 'B2C, Consumer Software, Information Technology, Internet, Legal Tech, Privacy, Software'}
CaseGuide, Inc. DBA Spire Technical Services	{'category': '', 'description': 'Spire Tech Services provides data science and automation services to Spire Law, a corporate and employment law firm based in Orlando, FL.', 'tags': 'Employment, Legal, Legal Tech'}
Hunit	{'category': '', 'description': 'SaaS for legal professionals to use smart contracts and blockchain', 'tags': 'Blockchain, FinTech, Information Technology, Legal Tech, SaaS'}
INKINDIALEGAL.com	{'category': '', 'description': 'Legal Tech Platform', 'tags': 'Legal Tech'}
PatentBot	{'category': '', 'description': 'TradeMark registration 2.0', 'tags': 'Apps, Legal, Legal Tech'}
MUST Platform	{'category': '', 'description': 'International marketplace of assets and financial instruments for SME and the platform of collateral and asset management', 'tags': 'Blockchain, FinTech, Legal Tech, Marketplace'}
MINEKO	{'category': '', 'description': 'PropTech & LegalTech Startup specialised in checking rental side costs and services around rental side costs.', 'tags': 'Legal Tech, Real Estate, Service Industry'}
Devlos Software	{'category': '', 'description': 'Devlos Software developers of Soluno,  the premier cloud-based time, billing, & accounting solution designed exclusively for law firms.', 'tags': 'Accounting, Enterprise Software, Law Enforcement, Legal, Legal Tech, Software'}
Amiqus Resolution	{'category': '', 'description': 'Amiqus Resolution is an online service to quickly and affordably resolve commercial disputes without appearing in court or tribunal.', 'tags': 'Legal Tech, Professional Services'}
Elabogado	{'category': '', 'description': 'Elabogado owns and operates an online directory of lawyers.', 'tags': 'Legal, Legal Tech, Marketing, Marketplace, Search Engine'}
HUGO.legal	{'category': '', 'description': 'HUGO.legal is the first sharing economy based legal platform using A.I to match people with the best lawyer for their case.', 'tags': 'Artificial Intelligence, Legal, Legal Tech'}
Predictice	{'category': '', 'description': 'Predictice provides real time, concrete, and strategic predictive analysis to law professionals.', 'tags': 'Analytics, Legal, Legal Tech, Predictive Analytics, Professional Services, Real Time'}
TranslateFX	{'category': '', 'description': 'TranslateFX provides instant and accurate translation of legal texts between different languages.', 'tags': 'Artificial Intelligence, Document Management, Legal Tech, Professional Services, Software, Translation Service'}
Kopjra	{'category': '', 'description': 'Making the Internet a safer place', 'tags': 'Cyber Security, Law Enforcement, Legal Tech'}
CloudLaw	{'category': '', 'description': 'CloudLaw is an online legal marketplace where consumers can find a lawyer and lawyers can connect with each other.', 'tags': 'Consumer, Legal, Legal Tech, Marketplace'}
Deleyes	{'category': '', 'description': 'Deleyes provides automated legal services.', 'tags': 'Consulting, Information Technology, Legal, Legal Tech, Software'}
Kings Court Trust	{'category': '', 'description': 'Kings Court Trust provides estate administration services for families in the United Kingdom.', 'tags': 'Legal, Legal Tech, Office Administration, Real Estate'}
Dealz.ai	{'category': '', 'description': 'Legal deal management platform', 'tags': 'Document Management, Ediscovery, Legal, Legal Tech, Project Management, Software, Venture Capital'}
Legal Manager	{'category': '', 'description': 'We provide consulting, technology and services for your legal operations.', 'tags': 'Legal, Legal Tech'}
Just Me Technologies	{'category': '', 'description': 'At Just Me, we help companies towards GDPR compliance, while giving back control of the personal data to their real owners: the users.', 'tags': 'Financial Services, FinTech, Information Technology, Legal Tech, SaaS, Software'}
Advokatguiden.no	{'category': '', 'description': 'Finn Norges beste advokater på AdvokatGuiden.no Vi hjelper deg å finne norske advokater over hele landet.', 'tags': 'Legal Tech'}
Tiqtime	{'category': '', 'description': 'TIQ’s mission is to explore new technologies to help people live and work smarter.', 'tags': 'Email, Legal, Legal Tech, Online Portals, Web Browsers'}
Student Connect	{'category': '', 'description': 'Student Connect helps evaluate and place entry-level legal talent by adopting a holistic approach based on actual performance feedback.', 'tags': 'Employment, Human Resources, Legal, Legal Tech'}
Trustlog	{'category': '', 'description': 'Recorded Handshake Deals On The Go', 'tags': 'Blockchain, Legal Tech'}
Divorce AI	{'category': '', 'description': 'Divorce AI is a B2C divorce financial planner that can predict child support, alimony, asset separation options, future budget and more.', 'tags': 'Artificial Intelligence, FinTech, Legal Tech'}
ECL Direct	{'category': '', 'description': 'ECL Direct is an online accounting firm that simplifies the accounting life of entrepreneurs and company creators.', 'tags': 'Accounting, Business Development, Legal, Legal Tech, Management Consulting'}
Grandeo Labs	{'category': '', 'description': 'Blockchain Applications & Cybersecurity', 'tags': 'Information Technology, Legal Tech, Software'}
EPIQ	{'category': '', 'description': 'Epiq Systems provides legal process outsourcing (LPO) services in the United States and internationally.', 'tags': 'Document Management, Ediscovery, Information Technology, Legal, Legal Tech'}
The Legal Capsule	{'category': '', 'description': 'The Legal Capsule is a contract lifecycle management (CLM) platform for companies to manage all their legal contracts.', 'tags': 'Contact Management, Intellectual Property, Legal Tech'}
Aalbul Ltd	{'category': '', 'description': 'Aalbun provides you with a predictable budget and gives you access to a highly talented global pool of IP professionals.', 'tags': 'Legal, Legal Tech'}
Testamenta	{'category': '', 'description': 'Testamenta is an online portal that enables individuals to get their wills processed legally from anywhere.', 'tags': 'Legal, Legal Tech, Product Research'}
Legalfinder.com	{'category': '', 'description': 'Legalfinder.com is a legal platform company.', 'tags': 'Legal, Legal Tech'}
JUIT	{'category': '', 'description': 'JUIT is a lawtech developing elegant technology so law practitioners do more in less time making data-driven decisions every day', 'tags': 'Analytics, Big Data, Business Intelligence, Legal Tech, Software'}
Assembly Software	{'category': '', 'description': 'Assembly Software is a legal technology company that is used by litigation and settlement firms, insurance companies, and defense firms.', 'tags': 'Legal, Legal Tech, Software'}
myBarrister	{'category': '', 'description': 'myBarrister is an online portal that provides direct access to legal advice barristers.', 'tags': 'Direct Marketing, E-Commerce, Legal, Legal Tech'}
Torrent Detective	{'category': '', 'description': 'Online anti-piracy service', 'tags': 'Analytics, Legal Tech, Software'}
JustBeagle	{'category': '', 'description': 'JustBeagle is the UK’s first market search and comparison site.', 'tags': 'Law Enforcement, Legal, Legal Tech'}
CodeLex	{'category': '', 'description': 'A Legal Tech startup', 'tags': 'Information Technology, Legal Tech'}
Bisnode	{'category': '', 'description': 'Bisnode is an European Data & Analytics company that enables people to make smart decisions.', 'tags': 'B2B, B2C, Big Data, Commercial, Credit, Information Services, Legal Tech'}
Zweispace	{'category': '', 'description': 'Top PropTech Company in APAC region,  awarded blockchain, Smartcontract patents, AI Architect, IoT, earthquake solution, Finteh & LegalTech.', 'tags': 'Architecture, Artificial Intelligence, Blockchain, FinTech, Internet of Things, Legal Tech, Predictive Analytics, Real Estate Investment, Smart Building'}
DocsCorp	{'category': '', 'description': 'DocsCorp designs easy-to-use software and services for document professionals who use enterprise content management systems.', 'tags': 'Content, Document Management, Information Services, Information Technology, Legal Tech, Software'}
APARAVI Software Corp	{'category': '', 'description': 'Aparavi provides data intelligence, automation software and services that empower organizations with control and knowledge of their data', 'tags': 'Business Intelligence, Cloud Data Services, Compliance, Data Center Automation, Legal Tech, SaaS, Software'}
Pibisi	{'category': '', 'description': 'Automatised KYC for regulated companies', 'tags': 'FinTech, InsurTech, Legal Tech, Software'}
Assistent.by	{'category': '', 'description': 'Assistent.by is team of professionals in the field of Internet projects (accounting and legal services).', 'tags': 'Accounting, Cloud Computing, Legal, Legal Tech'}
Lexware	{'category': '', 'description': 'Legal Tech company working with clients across Africa.', 'tags': 'Legal Tech'}
Nuvalaw	{'category': '', 'description': 'Resolving claims and disputes by processing legal information efficiently.', 'tags': 'Consulting, Information Technology, Legal, Legal Tech'}
Attorneys.org LLC	{'category': '', 'description': 'Online marketplace for legal services. Attorney and law firm directory with ratings and reviews.', 'tags': 'Consulting, Legal, Legal Tech'}
Expert Institute	{'category': '', 'description': 'Expert Institute is empowering firms with the world’s leading expertise.', 'tags': 'Consulting, Information Technology, Law Enforcement, Legal, Legal Tech'}
Prifina	{'category': '', 'description': 'Prifina is building tools that empower individuals to get superior value from their data; and user-centric data tools for developers.', 'tags': 'Artificial Intelligence, Big Data, Blockchain, Developer APIs, Legal Tech, Machine Learning, Open Source, Privacy, Software, Wealth Management'}
Legal Logs	{'category': '', 'description': 'LegalLogs empowers clients through mobile and desktop interfaces to feed task driven information into a case.', 'tags': 'Document Management, Information Services, Legal, Legal Tech, Software'}
passingboxes	{'category': '', 'description': 'passingboxes provides services to help secure your digital legacy and pass on the things that really matter.', 'tags': 'Information Services, Legal Tech, Web Browsers'}
Nefelex	{'category': '', 'description': 'Management and remote work for lawyers. All-in-one platform to manage your law firm anywhere', 'tags': 'B2B, Cloud Computing, Legal, Legal Tech, Project Management, SaaS, Software'}
CloudNine	{'category': '', 'description': 'eDiscovery automation company, SaaS', 'tags': 'Cloud Computing, Cloud Data Services, Document Management, Ediscovery, Enterprise Software, Information Technology, Legal, Legal Tech, SaaS, Software'}
Walkers	{'category': '', 'description': 'Walkers is an international law firm that provides legal, corporate, compliance, and fiduciary services to global corporations.', 'tags': 'Asset Management, Compliance, Finance, Legal, Legal Tech'}
CheKin	{'category': '', 'description': 'Chekin is the new standard to Check-in Guests. We digitalize guest registration to offer frictionless check-in to the tourism industry.', 'tags': 'Hospitality, Hotel, Information Technology, Legal Tech, Mobile Apps, SaaS, Software, Travel Accommodations, Vacation Rental'}
Prime Clerk	{'category': '', 'description': 'The new level of professionalism, innovation and transparency in bankruptcy administration.', 'tags': 'Legal, Legal Tech'}
Hukumonline.com	{'category': '', 'description': 'Hukumonline.com is a reg-tech company that provides the most complete, integrated and trusted legal products and services.', 'tags': 'Information Services, Legal, Legal Tech, Software'}
RightNow	{'category': '', 'description': 'RightNow revolutionizes peoples’ access to justice by reimbursing consumer claims within 24 hours, thus providing “justice-as-a-service”.', 'tags': 'Consumer, FinTech, Legal Tech'}
ZENDOC	{'category': '', 'description': 'Contract management made easy.', 'tags': 'Information Technology, Internet, Legal Tech'}
Pixsy	{'category': '', 'description': 'Pixsy helps professional photographers, artists and businesses find and fight image theft online.', 'tags': 'Image Recognition, Legal, Legal Tech, Photography, Software, Visual Search'}
6clicks	{'category': '', 'description': 'Risk assessment, risk management and compliance platform', 'tags': 'Compliance, Cyber Security, Legal Tech, Risk Management, Software'}
Lexplique	{'category': '', 'description': 'Lexplique operates a translation service and other services for lawyers around the world.', 'tags': 'Law Enforcement, Legal, Legal Tech, Translation Service'}
InfoTrack	{'category': '', 'description': 'InfoTrack is a global innovator in legal technology servicing the needs of the legal market.', 'tags': 'Legal, Legal Tech, Productivity Tools, SaaS'}
Lytt	{'category': '', 'description': 'Lytt is the first digital assistant that makes it easy and safe for employees to communicate sensitive topics at work', 'tags': 'Human Resources, Legal Tech, Software'}
Kurier	{'category': '', 'description': 'Kurier offers a data analytics platform so legal firms can monitor all the happenings going on within the Brazilian justice system.', 'tags': 'Legal, Legal Tech, Software'}
SurePoint Technologies	{'category': '', 'description': "For more than 40 years, law firms have relied on SurePoint's Legal Management System (LMS) to unlock higher performance.", 'tags': 'Legal Tech, Software'}
LexCheck	{'category': '', 'description': 'LexCheck uses computational linguistics technology to help improve the preparation of legal documents and other literature.', 'tags': 'Artificial Intelligence, Contact Management, Legal, Legal Tech, Natural Language Processing, SaaS, Software'}
Red Marker - AI powered compliance	{'category': '', 'description': 'Red Marker’s cloud-based SaaS platform automatically analyses digital content for probabilistic compliance risk using AI, ML and NLP', 'tags': 'Artificial Intelligence, Compliance, Education, Information Technology, Internet, Legal Tech, Machine Learning, SaaS'}
Pointer Brand Protection	{'category': '', 'description': 'Online brand protection that is monitoring e-commerce websites, domains and social media for intellectual property infringements.', 'tags': 'Domain Registrar, E-Commerce, Image Recognition, Information Technology, Intellectual Property, Legal, Legal Tech, Security, Social Media'}
Upstock	{'category': '', 'description': 'Worker equity management as a service, Founder Equity, Performance Based Equity, Saas, Legal Services, Membership', 'tags': 'Financial Services, FinTech, Legal, Legal Tech, SaaS, Software'}
Origin X Capital	{'category': '', 'description': 'A leading consultancy firm specialised in global business, legal, governance, and compliance for the financial technologies industry.', 'tags': 'Consulting, Financial Services, Legal, Legal Tech, Venture Capital'}
One Legal	{'category': '', 'description': 'One Legal is a suite of online tools that helps law firms and litigants to connect with the courts and their cases.', 'tags': 'Document Management, Legal, Legal Tech, Logistics, Software'}
LeadsOnline	{'category': '', 'description': 'LeadsOnline provides actionable intelligence that impacts the increased clearance rates of Part 1 crimes for law enforcement agencies.', 'tags': 'CivicTech, GovTech, Law Enforcement, Legal, Legal Tech'}
Congruity360	{'category': '', 'description': 'Congruity360, a single-source provider of Data Governance and eDiscovery solutions for corporations, law firms, & government organizations.', 'tags': 'Cloud Data Services, Cloud Infrastructure, Compliance, Ediscovery, Information Services, Information Technology, Infrastructure, Legal Tech, Risk Management'}
UFP Fintech	{'category': '', 'description': 'UFP Fintech invests in early stage Fintech, Proptech & Legaltech startups', 'tags': 'Angel Investment, Financial Services, FinTech, Legal Tech, Property Management, Venture Capital'}
RTIwala	{'category': '', 'description': 'RTIwala is a citizen-centric startup, empowering the masses through sensible content and affordable legal services.', 'tags': 'Consulting, Content Creators, Legal, Legal Tech, Media and Entertainment, News'}
Intelllex	{'category': '', 'description': 'Intelllex helps law firms unlock insights from their dormant data and discover what they really know.', 'tags': 'Information Technology, Legal, Legal Tech, Software'}
Legility	{'category': '', 'description': 'Legility provides consulting, technology, managed solutions, and flexible legal talent engagement services to corporations and law firms.', 'tags': 'Consulting, Information Technology, Legal, Legal Tech, Professional Services'}
Bella Professional Services	{'category': '', 'description': 'home of exceptional professional services at affordable prices.', 'tags': 'Facilities Support Services, Legal, Legal Tech, Professional Services'}
Mind-Alliance Systems	{'category': '', 'description': 'Actionable Business Intelligence for Lawyers', 'tags': 'Knowledge Management, Legal Tech, SaaS, Semantic Web, Software'}
AuraLawgic	{'category': '', 'description': 'Online platform for legal working professions.', 'tags': 'Legal Tech'}
CourtListener	{'category': '', 'description': 'CourtListener is a free legal research website containing millions of legal opinions from federal and state courts.', 'tags': 'Database, Legal, Legal Tech'}
Opus 2 International	{'category': '', 'description': 'Opus 2 provides litigation and court reporting services from locations on three continents.', 'tags': 'Consulting, Law Enforcement, Legal, Legal Tech'}
Legaltech	{'category': '', 'description': 'Digital data recovery service business', 'tags': 'Legal Tech, Management Consulting, Professional Services'}
Widr	{'category': '', 'description': 'Change the way we browse internet, starting with legal. Instead of getting millions of results for a few keywords, we answer your requests.', 'tags': 'Legal, Legal Tech, Mobile, Productivity Tools, SaaS, Search Engine, Software, Virtual Workforce'}
AppRocket	{'category': '', 'description': 'Fully-managed services marketplace for startup founders', 'tags': 'Artificial Intelligence, Computer Vision, E-Commerce, Information Technology, Legal Tech, Machine Learning, Product Management, Ride Sharing, SaaS'}
Legalku	{'category': '', 'description': 'Legalku is a legal tech company located in Kuningan Timur.', 'tags': 'Finance, Legal Tech, Logistics'}
Divorceify	{'category': '', 'description': 'A comprehensive divorce marketplace utilizing predictive technology to connect divorce consumers to vetted professional help & resources.', 'tags': 'Consumer, Legal, Legal Tech, Marketplace, Professional Networking'}
Livesense	{'category': '', 'description': 'Livesense aim to make our customers happy by using their services.', 'tags': 'Career Planning, Legal Tech, Recruiting'}
Loom Analytics	{'category': '', 'description': 'Loom Analytics is a legal data analytics company that builds analytics products for the legal and insurance industries.', 'tags': 'Analytics, Consulting, Information Technology, Legal, Legal Tech'}
LeapXpert Ltd	{'category': '', 'description': 'LeapXpert is a company who creates a platform that finally allows company employees to communicate with their clients on their own terms.', 'tags': 'B2C, Communication Hardware, Information and Communications Technology (ICT), InsurTech, Legal Tech, Software'}
LAWIO	{'category': '', 'description': 'LAWIO offers a wide range of information about tenancy law in Germany.', 'tags': 'Information Technology, Internet, Legal, Legal Tech, Software'}
Anwalt.de	{'category': '', 'description': 'Anwalt.de is legal platform that connects individuals and companies with lawyers.', 'tags': 'Information Services, Legal, Legal Tech, Online Portals'}
Marketly	{'category': '', 'description': 'Impactful Anti-piracy & Brand Protection Solutions.', 'tags': 'Enterprise Software, Legal Tech, SaaS'}
Stenovate	{'category': '', 'description': 'The only collaborative project management platform for legal transcript professionals.', 'tags': 'Legal, Legal Tech'}
Codekeeper BV	{'category': '', 'description': 'Source Code Escrow for Developers', 'tags': 'Internet, Legal, Legal Tech, Software'}
Sparqa Legal	{'category': '', 'description': 'The online legal platform providing expert guidance and auto-generated documents for business', 'tags': 'Legal, Legal Tech, Software'}
Bryan Cave Leighton Paisner	{'category': '', 'description': 'Bryan Cave Leighton Paisner is a fully integrated global law firm that provides clients with connected legal advice.', 'tags': 'Advice, Consulting, Legal, Legal Tech, Professional Services'}
Quiktract	{'category': '', 'description': 'P2P Legal Agreements, Payments & General Freelancer Tools', 'tags': 'Consumer Software, Freelance, Legal, Legal Tech, Mobile Apps, Mobile Payments'}
CodeREG	{'category': '', 'description': 'Smarter Compliance_', 'tags': 'Compliance, FinTech, Information Technology, Legal Tech'}
Pensieve	{'category': '', 'description': 'Pensieve is an AI-based legal research platform that helps users draft, review, and analyze legal documents.', 'tags': 'Artificial Intelligence, Legal, Legal Tech, Machine Learning, Natural Language Processing'}
LawCoin	{'category': '', 'description': 'LawCoin is a litigation finance and digital assets company.', 'tags': 'Blockchain, Financial Services, FinTech, Legal, Legal Tech, Lending, Venture Capital'}
ClearWay Law	{'category': '', 'description': 'The first 100% online law firm (online market place for legal services)', 'tags': 'Legal, Legal Tech'}
Legal Nodes	{'category': '', 'description': 'Legal Nodes is an online platform that helps tech startups define their legal needs and get it done globally quickly and easily.', 'tags': 'Blockchain, Information Technology, Legal, Legal Tech, Service Industry'}
McCarthyFinch	{'category': '', 'description': 'Changing how law works', 'tags': 'Artificial Intelligence, Legal Tech'}
1LAW	{'category': '', 'description': '1LAW is a mobile application that offers information about the law and provides help through lawyers.', 'tags': 'Legal, Legal Tech, Mobile Apps, Professional Networking, Professional Services'}
Lawtap	{'category': '', 'description': 'LawTap is the booking engine for lawyers.', 'tags': 'Consulting, Information Technology, Legal, Legal Tech, Software'}
BlockAxs GmbH	{'category': '', 'description': 'The BlockAxs toolbox will offer lifecycle management tools for your tokenization. Make it easy and secure!', 'tags': 'Blockchain, Contact Management, FinTech, Information Technology, Legal Tech, Security'}
GetID	{'category': '', 'description': 'Identity Verification Solution, KYC/Aml checks, Facial Recognition', 'tags': 'Information Technology, Legal Tech, Software'}
InFront Compliance, Inc.	{'category': '', 'description': 'SaaS platform that helps companies close vendor deals faster without sacrificing compliance.', 'tags': 'Compliance, Information Technology, Legal, Legal Tech'}
ExpressSteuer	{'category': '', 'description': 'AI-powered software automating the process of filing a german return', 'tags': 'Financial Services, Legal Tech, Software'}
Whooster	{'category': '', 'description': 'Whooster  Investigative  Data & Technology Platform.', 'tags': 'Analytics, Fraud Detection, Law Enforcement, Legal Tech, National Security, Risk Management, Software'}
peacefully	{'category': '', 'description': 'peacefully streamlines and automates end of life logistics for surviving loved ones', 'tags': 'Elder Care, Elderly, Financial Services, FinTech, Legal Tech'}
Summize	{'category': '', 'description': 'Legal Tech', 'tags': 'Information Technology, Legal, Legal Tech, Natural Language Processing, Predictive Analytics, Software'}
CEB	{'category': '', 'description': 'CEB is a legal services company that provides practical legal resources to help lawyers achieve success.', 'tags': 'Law Enforcement, Legal, Legal Tech'}
LegalPassage	{'category': '', 'description': 'Legal Passage educates and breaks down the divorce process into milestones and allows customers to more efficiently consume legal advice.', 'tags': 'Legal, Legal Tech, SaaS, Software'}
Legal Automation	{'category': '', 'description': 'Legal Automation is a software company that focuses on providing products intended for Underwriting and Claim Adjustment.', 'tags': 'Artificial Intelligence, Insurance, Legal Tech, Software'}
Cogneesol Inc.	{'category': '', 'description': 'Looking for an innovative and low-cost outsourcing service provider? Cogneesol is your ideal choice as the company.', 'tags': 'Accounting, B2B, Contact Management, Data Mining, Financial Services, Insurance, Legal, Legal Tech, Mobile Apps, Virtual Assistant'}
Legal One GmbH	{'category': '', 'description': 'Legal One is an agency for software development, marketing and content.', 'tags': 'Information Services, Information Technology, Legal Tech, Software'}
RegHub	{'category': '', 'description': 'RegHub is data-driven platform to reduce cost & complexity in regulatory change management and compliance through automation & collaboration', 'tags': 'Information Technology, Legal Tech, Software'}
Intaker	{'category': '', 'description': 'Intaker AI captures and qualifies prospective clients for law firms.', 'tags': 'Internet, Legal Tech, SaaS'}
Check in Scan	{'category': '', 'description': 'The most downloaded app for registering your holiday guests for legal compliance. Scan, Sign & Send!', 'tags': 'Hospitality, Hotel, Legal Tech, Mobile Apps, SaaS, Travel Accommodations, Vacation Rental'}
Digitory Legal	{'category': '', 'description': 'Digitory Legal is an automated budgeting and resource management platform for law firms and legal departments.', 'tags': 'Legal, Legal Tech, SaaS, Software'}
Balko	{'category': '', 'description': 'Balko is the first trading platform focused on illiquid assets in Brazil. We connect buyers and sellers of legal claims and NPLs', 'tags': 'Consulting, Financial Services, FinTech, Internet, Legal Tech, Trading Platform'}
CanadaVisa	{'category': '', 'description': 'CanadaVisa provides legal services related to Canadian immigration matters.', 'tags': 'Consulting, Legal, Legal Tech'}
LegalDocs	{'category': '', 'description': 'LegalDocs is a one stop shop for all your enterprise/ business related documentation service.', 'tags': 'Business Development, Consulting, Legal, Legal Tech, Software'}
Timeliss	{'category': '', 'description': 'Timeliss is a late-life technology innovations company that brings health, wealth and legacy planning matters onto one platform.', 'tags': 'Elder Care, Employee Benefits, Family, Information Technology, Legal Tech, Personal Finance, Wealth Management, Wellness'}
Legex	{'category': '', 'description': 'Legex is a legal service facilitator.', 'tags': 'Consulting, Legal Tech'}
TIQK	{'category': '', 'description': 'We simplify financial advice compliance', 'tags': 'Compliance, Financial Services, FinTech, Legal Tech'}
AiRelo	{'category': '', 'description': "World's First City Registration Assistant", 'tags': 'Artificial Intelligence, Government, GovTech, Human Resources, Information and Communications Technology (ICT), Information Services, Information Technology, Insurance, InsurTech, Legal Tech, Productivity Tools, SaaS, Virtual Assistant'}
DADSUN	{'category': '', 'description': 'The smart way to choose lawyer', 'tags': 'Artificial Intelligence, Information Technology, Legal, Legal Tech, Marketplace, Professional Services'}
Fiberhome	{'category': '', 'description': 'Fiberhome Telecommunication Technologies designs and manufactures telecommunication products.', 'tags': 'Communication Hardware, Hardware, Legal Tech, Manufacturing'}
Pergamin	{'category': '', 'description': 'Parchment is a solution that will organize the contracting process in your company. Create, negotiate and sign contracts in one secure tool.', 'tags': 'Legal Tech, Software'}
Valla	{'category': '', 'description': 'Data-driven tools for the legal industry', 'tags': 'Legal Tech, SaaS, Software'}
Gino LegalTech	{'category': '', 'description': 'Gino LegalTech is a legal startup that specialized in contract robotization.', 'tags': 'Contact Management, Legal, Legal Tech, Software'}
The National Law Review	{'category': '', 'description': 'The National Law Review is an online legal publication website focusing on breaking legal news for business and legal professionals.', 'tags': 'Legal Tech, News, Publishing'}
MGROUP	{'category': '', 'description': 'Tech Consulting & Project Management', 'tags': 'Blockchain, Consulting, Drones, Information Technology, Internet, Legal Tech'}
VantageBP	{'category': '', 'description': 'Brand Protection for the Modern World', 'tags': 'E-Commerce, Legal, Legal Tech'}
Legalbird	{'category': '', 'description': 'Legalbird helps consumers to solve their legal issues within minutes.', 'tags': 'Consulting, Internet, Legal Tech, Professional Services'}
Kontrak Hukum (Buatkontrak)	{'category': '', 'description': 'Kontrak Hukum (Buatkontrak) is a legal tech company located in Menteng.', 'tags': 'B2B, Legal Tech, Small and Medium Businesses'}
a360inc	{'category': '', 'description': 'a360inc is an employee-owned company', 'tags': 'Information Technology, Law Enforcement, Legal, Legal Tech'}
Document Modelling	{'category': '', 'description': 'Document Modelling is a Tech start up with a focus on the legal sector.', 'tags': 'Big Data, Business Intelligence, Cloud Data Services, Data Integration, Data Visualization, Database, Document Preparation, E-Signature, Information Technology, Legal Tech'}
Legalboards.io	{'category': '', 'description': 'Legalboards offers an agile workflow management system for legal practice.', 'tags': 'Collaboration, Information Services, Legal, Legal Tech, Productivity Tools, Project Management, Software'}
JDoe	{'category': '', 'description': 'Anonymous platform for reporting sexual misconduct', 'tags': 'Legal, Legal Tech, Mobile Apps, Privacy, Security'}
Mercatório	{'category': '', 'description': 'Mercatório was created in order to provide liquidity to those who hold this title and to facilitate the prospection of those who want to buy', 'tags': 'Credit, Finance, Financial Services, FinTech, Legal Tech'}
digitalCounsels	{'category': '', 'description': 'digitalCounsels provides a platform which allows legal service providers to digitize their business model.', 'tags': 'Internet, Legal, Legal Tech, Software'}
LegalForms	{'category': '', 'description': 'Document and Process Automation for small and medium sized law firms.', 'tags': 'Legal Tech'}
F-LEX	{'category': '', 'description': 'F-LEX is an online platform which connects pre-vetted law students to law firms and general counsel for a flexible, on demand service.', 'tags': 'Legal, Legal Tech'}
Suyo	{'category': '', 'description': 'Suyo leverages innovative technology to provide low-income families with affordable and reliable property rights formalization services.', 'tags': 'Consulting, Information Services, Information Technology, Legal Tech'}
Tagdox	{'category': '', 'description': 'Tagdox is a document analysis company developing a game changing technology in the document space for professional services.', 'tags': 'Document Management, Information Technology, Legal Tech'}
ipQuants AG	{'category': '', 'description': 'Innovation Analytics, Big Data,  Legal Analytics', 'tags': 'Analytics, Big Data, Business Intelligence, Legal Tech, Machine Learning, Natural Language Processing'}
Easyoffer	{'category': '', 'description': 'Easyoffer is a marketplace that serves as the meeting point for lawyers, accountants and clients.', 'tags': 'Information Services, Legal Tech, Marketplace, Professional Services'}
ZHIANT	{'category': '', 'description': 'ZHIANT is an on-demand legal outsourcing marketplace that offers smart and easy way for small-to-medium firms to scale resources.', 'tags': 'Consulting, Information Technology, Legal, Legal Tech, Marketplace'}
FMeasure	{'category': '', 'description': 'FMeasure provides artificial intelligence based services for merger and acquisition, corporate analytics and risk analysis.', 'tags': 'Analytics, Artificial Intelligence, Data Mining, Legal Tech, Machine Learning, Market Research, Natural Language Processing'}
Branding Technology Japan	{'category': '', 'description': 'Branding Technology is a Digital marketing business', 'tags': 'Freelance, Legal Tech, Management Consulting'}
OneWill	{'category': '', 'description': 'SaaS', 'tags': 'Blockchain, Consumer Software, Information Technology, Legal Tech, SaaS, Software'}
HELM360	{'category': '', 'description': 'Helm360 has gained extensive expertise in business intelligence and analytics.', 'tags': 'Information Services, Information Technology, Legal, Legal Tech, Software'}
Infolegale	{'category': '', 'description': 'Infolegale provides a legal information platform to monitor company solvency.', 'tags': 'Business Intelligence, Consulting, Information Services, Information Technology, Legal, Legal Tech, Software'}
SheriaSoft	{'category': '', 'description': 'SheriaSoft takes your legal practice into the palm of your hands', 'tags': 'Legal, Legal Tech, Management Information Systems, SaaS, Software, Web Hosting'}
Lawflex	{'category': '', 'description': 'LawFlex is a legal resource firm that allows businesses to access lawyers on a flexible basis at competitive rates.', 'tags': 'Legal Tech, Professional Networking, Professional Services'}
BlackStone Discovery	{'category': '', 'description': 'BlackStone Discovery is a consulting legal company located in Palo Alto.', 'tags': 'Consulting, Legal, Legal Tech'}
Hipla	{'category': '', 'description': 'Hipla is the smarter way to buy and sell property.', 'tags': 'InsurTech, Legal Tech, Real Estate'}
Claudius Legal Intelligence, Inc.	{'category': '', 'description': 'Legal Tech, SaaS, Predictive Analytics', 'tags': 'Legal Tech, SaaS, Software'}
Route1	{'category': '', 'description': 'The future of legal recruitment', 'tags': 'Human Resources, Internet, Legal Tech'}
The Law App	{'category': '', 'description': "An 'on demand' legal technology & marketplace that allows consumers to locate local lawyers and connect with them instantly by voice & video", 'tags': 'Legal, Legal Tech'}
audaxly	{'category': '', 'description': 'Saas', 'tags': 'Compliance, Legal Tech, SaaS'}
iCEIBA	{'category': '', 'description': 'Claim recovery platform for Small and Medium Businesses financing rightful claims and litigation', 'tags': 'FinTech, Legal Tech'}
Alu	{'category': '', 'description': 'Alu helps users rent apartments in Porto Alegre.', 'tags': 'Legal, Legal Tech, Mobile, Real Estate, Software'}
CCPA Toll Free	{'category': '', 'description': 'CCPA Toll Free makes Simple Privacy. Manage CCPA and GDPR Requests. Meet Deadlines. Track Compliance.', 'tags': 'Compliance, Legal Tech'}
Izwan & Partners	{'category': '', 'description': 'Tech companies, VC, & startup law firm', 'tags': 'Consulting, Information Technology, Legal, Legal Tech, Venture Capital'}
deephound	{'category': '', 'description': 'The Augmented Intelligence Agency', 'tags': 'Artificial Intelligence, B2B, Big Data, Business Intelligence, Financial Services, FinTech, InsurTech, Legal Tech'}
ApexCLE	{'category': '', 'description': 'ApexCLE is a nation-wide continuing legal education "CLE" provider.', 'tags': 'Advice, Consulting, Education, Legal, Legal Tech'}
ZipClaims	{'category': '', 'description': 'Disrupting the plaintiff bar', 'tags': 'InsurTech, Legal Tech'}
fastMatter	{'category': '', 'description': 'Legal Accounts & Practice Management System', 'tags': 'Accounting, Billing, Collaboration, Enterprise Software, Legal, Legal Tech, Project Management, Real Time, Software'}
Lexvoco	{'category': '', 'description': 'Lexvoco specializes in offering legal technology and legal services.', 'tags': 'Legal, Legal Tech, Professional Services'}
Veloxiti	{'category': '', 'description': 'Thinking Software - Innovative Human-Computer Productivity', 'tags': 'Artificial Intelligence, Government, Health Diagnostics, Information Technology, InsurTech, Legal Tech, Real Estate, Software'}
ZICO Law	{'category': '', 'description': 'ZICO Law is a network of independent local law firms that provide value-added legal services for organizations and individuals to succeed.', 'tags': 'Business Development, Legal, Legal Tech, Professional Services'}
Logwise	{'category': '', 'description': 'Logwise is an independent and entrepreneurial fintech company.', 'tags': 'Compliance, Financial Services, FinTech, Information Services, Information Technology, Legal Tech'}
Beti	{'category': '', 'description': 'Beti provides tools for success in securing on-site safety while complying with legal requirements.', 'tags': 'Cloud Management, Construction, Information Technology, Legal Tech, Software'}
IP Checkups	{'category': '', 'description': 'IP Checkups is a patent software firm located in Berkeley, California.', 'tags': 'Consulting, Information Technology, Intellectual Property, Legal Tech, Management Consulting, Professional Services, Software'}
Valire	{'category': '', 'description': 'Valire is a software solution company that specializes in the field of artificial intelligence.', 'tags': 'Artificial Intelligence, Finance, Legal Tech'}
SUMMARLY	{'category': '', 'description': 'Summarizing Everyday Communication', 'tags': 'Artificial Intelligence, Consulting, Email, Information Technology, Legal Tech, Machine Learning, Natural Language Processing'}
SIËSDE	{'category': '', 'description': 'SIËSDE innovates, creates and prototypes legal and dispute resolution technologies.', 'tags': 'Consulting, Information Technology, Legal, Legal Tech, Software'}
Deep Legal	{'category': '', 'description': 'Deep Legal monitors, compares, and predicts portfolios of lawsuits developed for the corporate management of companies with court records.', 'tags': 'B2B, Big Data, Legal, Legal Tech, SaaS'}
Compliance Sign	{'category': '', 'description': 'AI and ML tool for compliance, regulatory, and policy operations assisting people and never fully automating.', 'tags': 'Artificial Intelligence, Compliance, FinTech, Insurance, Legal Tech, Machine Learning, Natural Language Processing, SaaS'}
Acaya	{'category': '', 'description': 'A Thai LegalTech startup specializing in legal information retrieval, analytics, and NLP.', 'tags': 'Information Technology, Legal Tech, Natural Language Processing'}
Bilr	{'category': '', 'description': 'SaaS, LegalTech', 'tags': 'Legal Tech, Software'}
ShakeUp Online	{'category': '', 'description': 'ShakeUp Online operates an online platform that provides legal and professional services to small and medium enterprises.', 'tags': 'Consulting, Information Technology, Legal, Legal Tech, Software'}
LEGALIBOO	{'category': '', 'description': 'LEGALIBOO is a web platform that lets users get custom contracts and legal documents immediately and online.', 'tags': 'Assistive Technology, Document Management, Legal, Legal Tech, SaaS, Software'}
Searchbug	{'category': '', 'description': 'Search people, verify & append names, Property address, phone & email. Find contact info for people one at a time, in bulk or in real-time.', 'tags': 'Database, E-Commerce Platforms, Email Marketing, Information Technology, Internet, Legal Tech, Professional Services, Retail Technology'}
Alba Software	{'category': '', 'description': 'Alba is a lawtech company that provides integrated management and legal compliance system.', 'tags': 'Legal, Legal Tech, Software'}
Immortalize	{'category': '', 'description': 'Estate Planning Platform', 'tags': 'E-Commerce Platforms, FinTech, Legal Tech'}
Aleri	{'category': '', 'description': 'Aleri software streamlines the process of creating cross examination questions.', 'tags': 'Legal Tech, Software'}
Aldabada	{'category': '', 'description': 'Consumer contract management solutions. Never sign a contract you would regret. We create tech that watches your back.', 'tags': 'Consumer Applications, Information Technology, Internet, Legal Tech, Privacy, Software'}
GDPR Register	{'category': '', 'description': 'GDPR compliance productivity tool', 'tags': 'Legal Tech, Productivity Tools, SaaS'}
Legaline	{'category': '', 'description': 'Legaline is an online legal claims company specialized in claims that uses the most advanced technology.', 'tags': 'Legal, Legal Tech, Online Portals, Professional Services'}
SelfLawyer	{'category': '', 'description': 'Immigration forms preparation software', 'tags': 'Legal Tech'}
ligris.	{'category': '', 'description': 'Ligris is a law firm offering legal services in real estate, title resolution, corporate, small business, and leasing.', 'tags': 'Commercial Real Estate, Legal, Legal Tech, Real Estate, Real Estate Investment'}
Atims	{'category': '', 'description': 'Atims is a law enforcement company located in Los Angeles.', 'tags': 'Law Enforcement, Legal, Legal Tech'}
Africa Legal News	{'category': '', 'description': 'Africa Legal News is an online media startup and newsroom that reports on legal updates, analysis and news around Africa', 'tags': 'Blogging Platforms, Broadcasting, Internet Radio, Legal, Legal Tech, News, Video on Demand'}
Liquid Litigation Management	{'category': '', 'description': 'LLM brings you Liquid Lit Manager™, an integrated, web-based e-discovery and case management solution.', 'tags': 'Advice, Consulting, Information Technology, Legal, Legal Tech'}
AudioLock	{'category': '', 'description': 'AudioLock provides music anti-piracy services for rights holders and is trusted worldwide by leading labels, artists and distributors.', 'tags': 'Internet, Legal Tech, Music'}
LegalMaps	{'category': '', 'description': 'SaaS', 'tags': 'Consulting, Information Technology, Internet, Legal, Legal Tech, SaaS, Software'}
Finnovating	{'category': '', 'description': 'FinTech Open Innovation Platform that accelerates the collaboration between more than 30.000 FinTech with Corporates & Investors worldwide.', 'tags': 'Developer Platform, FinTech, InsurTech, Legal Tech'}
Ocaflow	{'category': '', 'description': 'We help brazilian companies manage their shareholders contracts, incentive programs, equity plans and cap table information in real time.', 'tags': 'Accounting, Human Resources, Legal Tech, Software'}
3Lawgy	{'category': '', 'description': '3Lawgy is a sharing economy platform for legal services.', 'tags': 'FinTech, Legal, Legal Tech'}
LegalComet	{'category': '', 'description': 'LegalComet is a specialist Legal Technology advisory firm with a focus on delivering innovation-driven solutions.', 'tags': 'Consulting, Information Technology, Legal, Legal Tech'}
Novus Law	{'category': '', 'description': 'Novus Law is a legal services firm that  brings the science that clients and their law firms need to enhance the art of practicing law.', 'tags': 'Legal, Legal Tech'}
Privatica	{'category': '', 'description': 'Privatica is a customers data management platform, designed to manage customers, leads and visitors data.', 'tags': 'Compliance, Cyber Security, Data Integration, Data Visualization, Legal Tech, Privacy'}
Lawgarithm	{'category': '', 'description': 'Lawgarithm is an innovative company that offers software that uses artificial intelligence to address contracts.', 'tags': 'Artificial Intelligence, Big Data, Information Technology, Legal Tech, Machine Learning, Software'}
AudioCaseFiles	{'category': '', 'description': 'AudioCaseFiles and Courtroom View Network offer multimedia content to the legal community.', 'tags': 'Ediscovery, Information Technology, Legal, Legal Tech, Software'}
Sahu4You.Com	{'category': '', 'description': 'Web Design And Development', 'tags': 'Information Technology, Legal Tech, News, Online Portals, Small and Medium Businesses'}
Inheryt	{'category': '', 'description': 'Inheryt is an online platform for wealth and end of life management.', 'tags': 'Information Technology, Legal Tech'}
Black Swan Digital Forensics	{'category': '', 'description': 'Digital Forensics', 'tags': 'Digital Media, Law Enforcement, Legal Tech'}
BlxLaw	{'category': '', 'description': 'BlxLaw as your virtual regulatory co-pilot, who takes care of meeting your regulatory requirements automatically or near-automatically.', 'tags': 'Legal Tech'}
DocPro	{'category': '', 'description': 'Professional Document platform for Individuals and Businesses to Create professional documents and legal contracts effortlessly for FREE.', 'tags': 'Document Preparation, Information Technology, Internet, Legal Tech, Online Portals, Software'}
FilersKeepers	{'category': '', 'description': 'FilersKeepers is a legal tech company that helps companies decide which retention period to choose per system or document category.', 'tags': 'Compliance, Legal, Legal Tech'}
eifas	{'category': '', 'description': 'SaaS Financial Advisory Platform', 'tags': 'Accounting, Debt Collections, Financial Services, Information Technology, Legal Tech, Office Administration, SaaS, Software'}
Will 2 Click	{'category': '', 'description': 'Mobile App', 'tags': 'Legal Tech, Mobile Apps'}
AENVI	{'category': '', 'description': 'Legal services marketplace', 'tags': 'Legal Tech, Marketplace'}
Parallel Solutions	{'category': '', 'description': 'Parallel is an email automation and information management solution that helps professionals be more productive.', 'tags': 'Legal Tech, Software'}
Chudnovsky Law	{'category': '', 'description': "Chudnovsky Law is a criminal defense and plaintiff's personal injury law firm and legal tech investor in Los Angeles and Orange County, CA.", 'tags': 'Advice, Legal, Legal Tech'}
Crefovi	{'category': '', 'description': 'Crefovi, a London & Paris law firm specialised in advising the creative industries wherever they are in the world.', 'tags': 'Consulting, Digital Entertainment, Fashion, Law Enforcement, Legal, Legal Tech, Music, Product Design'}
Moviinn	{'category': '', 'description': 'Moviinn is a online community that brings internationals and locals together.', 'tags': 'Association, Communities, Consulting, Internet, Legal, Legal Tech, Social Media'}
Uitelkaar.nl	{'category': '', 'description': "uitelkaar.nl's purpose is to support couples in the emotional period of separation.", 'tags': 'Information Technology, Legal, Legal Tech, Professional Services, Software'}
Abogados NOW	{'category': '', 'description': 'Bilingual Digital Marketing Consultancy for Attorneys', 'tags': 'Advertising, Legal, Legal Tech, Mobile Advertising'}
id est avocats	{'category': '', 'description': 'Swiss based boutique law firm providing expert advice in innovation, tech, media, advertising, corporate transactions, IP and privacy', 'tags': 'Advice, FinTech, Legal, Legal Tech, Life Science, Venture Capital'}
Draftr	{'category': '', 'description': 'Draftr is a SaaS platform for lawyers that enables collaboration and sharing of practice materials and information.', 'tags': 'Communities, Crowdsourcing, Legal Tech, SaaS, Software'}
Environmental Health Coalition	{'category': '', 'description': 'Environmental Health Coalition is a legaltech company.', 'tags': 'Legal, Legal Tech'}
LEXAI	{'category': '', 'description': 'Contract Review Platform', 'tags': 'Artificial Intelligence, Legal Tech'}
Masoomeen Quran Center	{'category': '', 'description': 'Masoomeen Quran Center is one of the largest online platforms for Shia Muslims to learn Quran.', 'tags': 'Education, Higher Education, Internet, Legal Tech, Primary Education, Secondary Education, Training'}
Coretext	{'category': '', 'description': 'Coretext is a stealth-mode B2B SaaS company that helps businesses on how they should manage their legal affairs.', 'tags': 'B2B, Legal Tech, Productivity Tools, Risk Management, SaaS'}
FilingMantra	{'category': '', 'description': 'Filing Mantra is online tax filing platform for small business, freelancers, and individuals.', 'tags': 'Financial Services, FinTech, Legal, Legal Tech, Software'}
Jurimetric	{'category': '', 'description': 'Jurimetric is a web platform with several resources to make informed decisions in law through statistics applied to jurisprudence.', 'tags': 'B2B, Data Center, Legal, Legal Tech, Sales'}
DadPardaz	{'category': '', 'description': 'DadPardaz is an online two-sided marketplace which connects lawyers to clients who need legal services.', 'tags': 'B2B, B2C, Contact Management, Legal, Legal Tech, Marketplace, Professional Services, Sharing Economy'}
LexDock	{'category': '', 'description': 'SAAS Marketplace for Legal Services and Matter Management connecting Business to Specialized Legal Practioners', 'tags': 'Legal, Legal Tech, Marketplace'}
Patent Digest	{'category': '', 'description': 'Patent digest offers artificial Intelligence based services for patent tracking, search and lawyer recommendation.', 'tags': 'Artificial Intelligence, Data Mining, Information Services, Legal, Legal Tech, Machine Learning, Natural Language Processing'}
Politico Group	{'category': '', 'description': 'Politico Group is a consulting company that specializes in non-partisan, full service public affairs, legislative advocacy.', 'tags': 'Consulting, Legal Tech, Professional Services'}
Legal Innovators	{'category': '', 'description': 'Legal Innovators, a legal service provider that changes the way the law approaches hiring, pricing, and diversity of junior legal talent.', 'tags': 'Law Enforcement, Legal, Legal Tech'}
Tod.d: Your Virtual Chief of Staff	{'category': '', 'description': 'Virtual Business Operations Management for Law Firms', 'tags': 'Accounting, Consulting, Finance, Human Resources, Internet, Legal Tech, Office Administration, Outsourcing, Scheduling, Travel'}
LCM Finance	{'category': '', 'description': 'LCM Finance specialize in providing litigation finance for companies and individuals for recovery of funds for legal claims.', 'tags': 'Legal, Legal Tech'}
Berkman Solutions	{'category': '', 'description': 'Provides Lextree, the web application for legal professionals to manage legal entities, contracts, board of directors, compliance, and risk.', 'tags': 'Compliance, Document Management, Legal Tech, Risk Management, Software'}
Sem Processo	{'category': '', 'description': 'Sem Processo provides legal solutions for companies.', 'tags': 'Business Information Systems, Business Intelligence, Consulting, Information Technology, Internet, Legal, Legal Tech, Management Consulting'}
law4tw	{'category': '', 'description': 'Law4tw provides a full range of self-help legal documents such as civil, family, and business.', 'tags': 'Consulting, Document Management, Information Services, Information Technology, Internet, Legal, Legal Tech'}
Justice Solutions Group	{'category': '', 'description': 'Private Investigations and Intelligence Firm', 'tags': 'Business Intelligence, Consulting, Legal, Legal Tech'}
MileMark Media	{'category': '', 'description': 'We provide the highest quality legal marketing solutions with superior customer service.', 'tags': 'Digital Marketing, Legal Tech, Marketing, SEO'}
Braina	{'category': '', 'description': 'Braina provides intellectual property services specialized for small and medium-sized enterprises.', 'tags': 'Intellectual Property, Legal, Legal Tech'}
Qrative	{'category': '', 'description': 'Qrative offers an intellectual property research and analysis for patent prosecution and litigation services.', 'tags': 'Business Development, Intellectual Property, Legal Tech'}
GoodCall	{'category': '', 'description': 'GoodCall operates a consumer-focused Website to provide information needed to make educated financial decisions.', 'tags': 'Information Technology, Law Enforcement, Legal, Legal Tech, Professional Services'}
JW LEGAL INNOVATION SAS DE CV	{'category': '', 'description': 'LEGAL TECH FIRM', 'tags': 'Information Technology, Legal Tech'}
Matters.Cloud	{'category': '', 'description': 'Matters.Cloud provides lawyers with an easy way to manage existing clients and matters.', 'tags': 'Advice, Consulting, Legal, Legal Tech, Software'}
Anika Legal	{'category': '', 'description': 'Anika Legal is an online platform that provides free legal advice to people who need it, and practical legal training to law students.', 'tags': 'Legal, Legal Tech'}
Record Grabber	{'category': '', 'description': 'Record Retrieval', 'tags': 'Electronic Health Record (EHR), Legal Tech'}
Cysae	{'category': '', 'description': 'Cysae is a firm specialized in legal advice on startups, fintech, data protection, technological law and legaltech.', 'tags': 'Blockchain, Legal, Legal Tech'}
InCorp Services	{'category': '', 'description': 'InCorp Services is a legal and staffing agency company located in Las Vegas.', 'tags': 'Legal, Legal Tech, Staffing Agency'}
Signature Closers	{'category': '', 'description': 'Signature Closers provides full- and self-service signing support for title companies and lenders.', 'tags': 'Legal, Legal Tech, Professional Services'}
Avallo	{'category': '', 'description': 'Regtech', 'tags': 'Information Technology, Legal Tech'}
Otica.ai	{'category': '', 'description': 'Otica is a LegalTech platform designed to help legal professionals share and monetize their knowledge.', 'tags': 'Artificial Intelligence, Big Data, Internet, Legal Tech'}
Vicente Sederberg	{'category': '', 'description': 'Vicente Sederberg is a top-ranked national cannabis law firm providing legal and policy services to marijuana and hemp companies.', 'tags': 'Law Enforcement, Legal, Legal Tech'}
DiJu	{'category': '', 'description': 'Boost your productivity with seamless word-processing and search applications designed for and by lawyers.', 'tags': 'Information Technology, Legal Tech, Software'}
Litigation Master	{'category': '', 'description': 'Litigation Master is an AI startup that developed software with contextual analysis to review legal documents and financial statements.', 'tags': 'Analytics, Artificial Intelligence, Big Data, Legal Tech'}
Merton Lawyers	{'category': '', 'description': 'Merton Lawyers is a law firm that offers commercial, corporate, property, conveyancing, and litigation advice.', 'tags': 'Advice, Consulting, Legal, Legal Tech'}
Candor Consulting	{'category': '', 'description': 'Candor Consulting provides a custom solution for each client and is there to guide organizations.', 'tags': 'Consulting, Legal Tech, Management Consulting'}
LawHero	{'category': '', 'description': 'LawHero is a web application that connects people who need legal advice,  with lawyers for a virtual consultation at affordable prices.', 'tags': 'B2B, Information Technology, Legal, Legal Tech, Marketplace, Software'}
Clemta	{'category': '', 'description': 'SaaS tool to automatize incorporations and post-incorporation in Delaware.', 'tags': 'Legal Tech, SaaS, Software'}
Huttons	{'category': '', 'description': 'Huttons aims to services that provide you with the confidence you need so you can focus on enjoying life, or building your business.', 'tags': 'Law Enforcement, Legal, Legal Tech'}
Legal Research Center	{'category': '', 'description': 'LegalResearch.com, a division of Legal Research Center, Inc., brings together a powerful legal research.', 'tags': 'Consulting, Legal, Legal Tech'}
Planet Data	{'category': '', 'description': 'Contract Analysis with AI', 'tags': 'Analytics, Artificial Intelligence, Contact Management, Legal Tech, Software, Text Analytics'}
Legal Hub	{'category': '', 'description': 'Legal Hub provides access to a wide strategic and facilitative advice, such as ethical prospecting of clients and management of suppliers.', 'tags': 'Advice, Legal, Legal Tech'}
One Protect	{'category': '', 'description': 'One Protect provides a variety of services in the field of administrative management systems for businesses and individuals.', 'tags': 'Automotive, CivicTech, Fleet Management, Legal Tech, Parking'}
Referent	{'category': '', 'description': 'Referent is a portal offers full legal support via the Internet.', 'tags': 'Internet, Legal, Legal Tech'}
The Time Billing	{'category': '', 'description': 'The Time Billing is a software firm that provides services to lawyers and law firms.', 'tags': 'Billing, Business Development, Legal, Legal Tech, Software'}
LexMeet	{'category': '', 'description': "LexMeet is a mobile app that provides legal advice to its client's legal problems.", 'tags': 'Advice, Legal Tech, Mobile Apps'}
Adidem Corporation	{'category': '', 'description': 'Adidem provides software to obtain legal proposals from multiple lawyers for any injury claim.  Compare quotes to see who to hire', 'tags': 'Information Technology, Legal, Legal Tech, Software'}
Benoam	{'category': '', 'description': 'Benoam specializes in technological, computerized solutions for the management of legal proceedings and legal data.', 'tags': 'Angel Investment, Asset Management, Legal, Legal Tech'}
Kobi AI	{'category': '', 'description': 'Kobi AI automates the initial consultation stage of the client-lawyer relationship.', 'tags': 'Artificial Intelligence, Legal, Legal Tech, Software'}
aapkaadvocate.com	{'category': '', 'description': 'legal Advice, RTI, phone consultation', 'tags': 'Legal, Legal Tech'}
CYW SOLUTIONS	{'category': '', 'description': 'Anti-Money Laundering Consultancy and RegTech software', 'tags': 'Financial Services, Information Technology, Legal Tech, Software'}
summing	{'category': '', 'description': 'SaaS, git for lawyers', 'tags': 'Legal Tech, SaaS'}
Buddle	{'category': '', 'description': 'Buddle is an online marketplace for legal resources for the cannabis industry.  SaaS, B2B, Legal Cannabis', 'tags': 'B2B, Cannabis, Legal Tech, SaaS, Social Entrepreneurship'}
SueApp	{'category': '', 'description': 'SueApp is an app for small claims filing and case management.', 'tags': 'Apps, Legal Tech'}
Companyon	{'category': '', 'description': 'Legal for businesses, simplified.', 'tags': 'Legal, Legal Tech'}
GGRUS Technologies Private Limited	{'category': '', 'description': 'Mobile App. Public grievance expression, escalation, redressal & resolution thru e-conciliation & e-courts of law. Pre+post shopping service', 'tags': 'Consumer, E-Commerce, Legal Tech'}
Legal Loans	{'category': '', 'description': 'Legal Loans provide financial assistance through pre-settlement funding, superior service and rapid response to clients.', 'tags': 'Legal, Legal Tech'}
PacerDash	{'category': '', 'description': 'PacerDash is a platform that enables users to import, track, and retrieve dockets.', 'tags': 'Document Management, Legal, Legal Tech'}
BGC Brasil	{'category': '', 'description': 'BGC Brasil is the leading provider of high volume background checks in Brazil especially for the gig economy', 'tags': 'Developer APIs, Enterprise Software, Human Resources, Information Services, Legal, Legal Tech, Public Safety'}
Tvuna Software Industries	{'category': '', 'description': 'Tvuna is a computer software company that specializes in law, corporate governance, law-tech, and legal technology.', 'tags': 'Computer, Legal Tech, Software'}
Free Legal Aid	{'category': '', 'description': 'Free Legal Aid is creating a website focused on giving free legal information to the public.', 'tags': 'Commercial, Legal, Legal Tech'}
Disputec PeaceMaker	{'category': '', 'description': 'Disputec PeaceMaker provides technological tools for litigations, legal advice, and arbitrations in the branches of law.', 'tags': 'Data Center Automation, Information Technology, Legal, Legal Tech, Software'}
Peace Talks Mediation	{'category': '', 'description': 'Peace Talks Mediation is a full service mediation firm that specializes in helping people in a sane and sensible manner.', 'tags': 'Law Enforcement, Legal, Legal Tech'}
Bengoshi Talk	{'category': '', 'description': 'Bengoshi Talk is an application that provides free legal consultation from lawyers.', 'tags': 'Apps, Consulting, Legal, Legal Tech, Software'}
Lawhawk	{'category': '', 'description': 'LawHawk is for lawyers and procurement specialists that want to prepare great legal and procurement documents as fast as possible', 'tags': 'Information Services, Information Technology, Legal, Legal Tech'}
Nubbius	{'category': '', 'description': 'Nubbius develops software for lawyers in a secure cloud.', 'tags': 'Consulting, Information Technology, Legal, Legal Tech, Software'}
QuickWill	{'category': '', 'description': 'Will Writer', 'tags': 'Legal Tech'}
Soocasa	{'category': '', 'description': 'Soocasa is an online platform created to facilitate the buying and selling of residential real estate through lease option programs.', 'tags': 'Legal, Legal Tech, Property Management, Real Estate, Rental Property'}
Righty	{'category': '', 'description': 'Righty is a payroll testing platform helping employers minimize paycheck errors globally, quickly, easily, and affordably.', 'tags': 'Apps, Finance, Financial Services, Legal Tech, Recruiting'}
Saxton and Stump	{'category': '', 'description': 'Saxton & Stump is a full-service law firm serving businesses by providing legal and consulting services.', 'tags': 'Law Enforcement, Legal, Legal Tech'}
Bis-Tec Technologies	{'category': '', 'description': 'Bis-Tec provides solution in the fields of computer forensic, E-discovery, cyber, and big data analysis.', 'tags': 'Big Data, Cyber Security, Information Technology, Legal Tech'}
AOS Korea	{'category': '', 'description': 'AOS Korea provides legal tech, AI chatbot and intelligent cloud backup services.', 'tags': 'Artificial Intelligence, Information Technology, Legal Tech'}
Visitation Ease	{'category': '', 'description': 'Fair Visitation for Everyone.', 'tags': 'Android, Information Technology, iOS, Legal Tech, Software'}
Iuris NOW	{'category': '', 'description': 'Iuris NOW is a platform that offers you the best professionals in the legal sector', 'tags': 'Legal, Legal Tech'}
BlackLetter	{'category': '', 'description': 'BlackLetter is an encrypted attorney-client communication and collaboration software that enables lawyers and clients to communicate.', 'tags': 'Collaboration, Communications Infrastructure, Document Management, Legal, Legal Tech, Mobile, Software'}
BAI Digital	{'category': '', 'description': 'Web Design and SEO', 'tags': 'Finance, Internet, Legal, Legal Tech, Telecommunications, Web Design, Web Development'}
Enact Conveyancing	{'category': '', 'description': 'Enact Conveyancing is a Legal Services company located in Leeds.', 'tags': 'Finance, Legal, Legal Tech'}
Pisar.bg	{'category': '', 'description': 'Pisar.bg is a technology platform, which helps people found their own business - fast, easy and secure.', 'tags': 'Accounting, Document Preparation, Information Technology, Legal, Legal Tech'}
Van Norman Law	{'category': '', 'description': 'Van Norman Law is a provider of high-quality legal services at an affordable rate to anyone who was in need of legal representation.', 'tags': 'Law Enforcement, Legal, Legal Tech'}
lex.be	{'category': '', 'description': 'Lex.be provides access to legal databases and increase law professionals efficiency.', 'tags': 'Database, Information Services, Information Technology, Legal, Legal Tech, Professional Services'}
MutuAlies	{'category': '', 'description': 'Legal Technology Company', 'tags': 'Legal Tech'}
Goodrich & Geist PC	{'category': '', 'description': 'Goodrich & Geist, P.C is a personal injury lawyer.', 'tags': 'Law Enforcement, Legal Tech, Professional Services'}
MyDefence	{'category': '', 'description': 'MyDefence is a digital-first legal platform that streamlines the criminal legal process to make the law affordable to all.', 'tags': 'Legal Tech'}
Legal Resolved	{'category': '', 'description': 'Legal Resolved is committed to provide online free and paid legal help to resolve legal issues by providing consultation.', 'tags': 'Consulting, Information Technology, Legal, Legal Tech'}
Bernabei & Wachtel	{'category': '', 'description': 'Bernabei & Wachtel is a law practice company located in Washington.', 'tags': 'Consulting, Legal, Legal Tech'}
ADR Notable, LLC	{'category': '', 'description': 'ADR Notable is the first technology platform built specifically to work with mediators and other dispute resolution professionals.', 'tags': 'Legal Tech'}
Da Vinci Partners LLC	{'category': '', 'description': 'Da Vinci Partners LLC is a company specializing in the case of the global product or service industry war.', 'tags': 'Legal, Legal Tech, Professional Services'}
Uniproof	{'category': '', 'description': 'Uniproof is a digital platform for registration of electronic documents in Registry Office.', 'tags': 'Document Management, Information Technology, Legal Tech'}
Legable	{'category': '', 'description': 'Automated legal document analysis and annotation for consumers.', 'tags': 'Legal, Legal Tech'}
FP Partner	{'category': '', 'description': 'FP Partner is a consulting company', 'tags': 'Legal Tech, Management Consulting'}
Edilex	{'category': '', 'description': 'Legal Tech Saas', 'tags': 'Legal Tech, SaaS, Software'}
The Technolawgist	{'category': '', 'description': 'The Technolawgist is a media company that publishes the original content about legal innovation and legal tech.', 'tags': 'Legal, Legal Tech, News'}
Noell Consulting Group	{'category': '', 'description': 'Noell Consulting Group helps you make decisions based on marketunistic advice counsel.', 'tags': 'Consulting, Legal Tech, Management Consulting'}
VictorAi	{'category': '', 'description': 'Artificial Intelligence', 'tags': 'Artificial Intelligence, Enterprise Applications, Legal Tech, Machine Learning, Natural Language Processing'}
IIPRD	{'category': '', 'description': 'IIPRD is a premier Patent Support, Technology Consulting, and IP Licensing Firm', 'tags': 'Legal Tech'}
Kondracki Celej	{'category': '', 'description': 'VC/Startup legal advisers', 'tags': 'Legal Tech'}
Berlin Patten Ebling	{'category': '', 'description': 'Berlin Patten Ebling is a full service transactional and litigation firm, focusing primarily on real estate related matters.', 'tags': 'Law Enforcement, Legal Tech, Real Estate'}
PointOFLAW	{'category': '', 'description': 'Marketplace', 'tags': 'Legal Tech'}
AllMed	{'category': '', 'description': 'AllMed is a platform that connects legal and medical professionals to seek medical claims services.', 'tags': 'Health Care, Legal Tech, Private Social Networking'}
Stevens & Williamson Attorneys at Law	{'category': '', 'description': 'Stevens & Williamson Attorneys at Law is a legal tech company located in Alpharetta.', 'tags': 'Law Enforcement, Legal, Legal Tech'}
IurFRIEND	{'category': '', 'description': "IurFRIEND is Germany's first curated legal shopping company.", 'tags': 'Consulting, Information Technology, Legal, Legal Tech'}
Softinfo	{'category': '', 'description': 'Softinfo creates and distributes ConsultantPlus systems.', 'tags': 'Legal Tech'}
The Center for Computer-Assisted Legal Instruction	{'category': '', 'description': 'CALI is a non-profit consortium of law schools, law libraries, and related organizations.', 'tags': 'Education, Legal, Legal Tech'}
LegaleFacile	{'category': '', 'description': 'LegaleFacile is a documents automation online service, which provides legal documents in contract, corporate and inheritance law areas.', 'tags': 'Legal, Legal Tech, Professional Services'}
Hanrei Times Holdings	{'category': '', 'description': 'Legal Times Holdings Co is Proceeding with the Times Group holding company and group strategy', 'tags': 'Legal Tech, Management Consulting, Publishing'}
Meu Primeiro Ape	{'category': '', 'description': 'Meu Primeiro Ape is a technology and advisory company.', 'tags': 'Apps, B2C, Legal, Legal Tech, Real Estate, Software'}
Virtual Pricing Director	{'category': '', 'description': 'Legal Pricing made Simple', 'tags': 'Legal, Legal Tech'}
Planet Patent	{'category': '', 'description': 'Planet Patent is a professional patent search services company that specializes in aerospace medical & software patent searches.', 'tags': 'Consulting, Legal, Legal Tech'}
Advc8	{'category': '', 'description': 'ADVC8 is the dedicated reputational management and new business generation platform for the legal sector.', 'tags': 'Lead Generation, Legal Tech, Public Relations, Residential'}
We Legalize	{'category': '', 'description': 'We Legalize is a team of highly passionate and professional Chartered Accountants and legal Advisors under one roof.', 'tags': 'Accounting, Corporate Training, Digital Marketing, Financial Services, Internet, Legal Tech, Professional Services, Web Development'}
Alliance Protection & Investigation	{'category': '', 'description': 'Alliance Intelligence and Investigations is an independently owned and operated investigations  firm .', 'tags': 'Consulting, Legal, Legal Tech'}
Handelonthelaw	{'category': '', 'description': 'Handelonthelaw is a law enforcement company.', 'tags': 'Law Enforcement, Legal Tech, Professional Services'}
Dimension Informatique Realisations	{'category': '', 'description': 'Dimension Informatique Realisations specializes in legal software for accessible, qualified and protected management data.', 'tags': 'Legal Tech, Software'}
Migration Agent and Immigration Lawyer Association	{'category': '', 'description': 'Ask-An-Agent is the trusted online marketplace connecting consumers and businesses with migration agents and immigration lawyers.', 'tags': 'Legal, Legal Tech'}
Suitup Israel	{'category': '', 'description': 'Suitup Israel is a revolutionary app for finding your dream job in the law profession.', 'tags': 'Apps, Human Resources, Legal Tech, Recruiting'}
Acordo Fechado	{'category': '', 'description': 'Acordo Fechado develops an online mediation and conciliation platform created to resolve disputes between consumers and businesses.', 'tags': 'Advice, Apps, Developer Platform, Legal, Legal Tech'}
Escola de Cálculos	{'category': '', 'description': 'Escola de Cálculos specializes in judicial calculations in the most diverse legal matters,.', 'tags': 'Advice, B2B, Legal, Legal Tech'}
LinkLei	{'category': '', 'description': 'LinkLei is an exclusive social network for lawyers that seeks to develop, strengthen, and promote the image of young professionals.', 'tags': 'B2B, B2C, Legal, Legal Tech'}
Legalcloud	{'category': '', 'description': 'Legalcloud streamlines the calculation and control of procedural deadlines, bringing peace of mind and productivity to lawyers.', 'tags': 'Information Services, Legal, Legal Tech, Software'}
London Law Agency	{'category': '', 'description': 'London Law Agency is a provider of company formation and corporate compliance services.', 'tags': 'Legal, Legal Tech'}
Ingensity IP	{'category': '', 'description': 'Ingensity IP provides strategic intellectual property advice to life science companies in sync with their business goals and timelines.', 'tags': 'Biotechnology, Intellectual Property, Legal, Legal Tech, Life Science'}
NovaProlink Tecnologia	{'category': '', 'description': 'NovaProlink Tecnologia develops legal software solutions for law firms and legal information, and innovative workflow.', 'tags': 'Advice, Information Technology, Legal, Legal Tech, Software'}
Church General Counsel	{'category': '', 'description': 'Pastor-led law firm helping churches be more secure, effective, and efficient through policy & process management.', 'tags': 'Legal, Legal Tech, Religion'}
Buche & Associates Pc	{'category': '', 'description': 'Buche & Associates Pc is a legal  company specializes in intellectual property law located in San Diego.', 'tags': 'Consulting, Law Enforcement, Legal Tech'}
Berkelyn	{'category': '', 'description': 'Legal consulting services and property rights & real estate ownership claims solutions for private space actors, internationally.', 'tags': 'Aerospace, Legal, Legal Tech'}
Mccoy|fatula	{'category': '', 'description': 'McCoy Fatula is a law firm that specializes in providing family law and estate planning solutions.', 'tags': 'Law Enforcement, Legal, Legal Tech'}
RA MICRO Software	{'category': '', 'description': 'RA-MICRO develops and sells industry-specific solutions and services for lawyers and notaries.', 'tags': 'Information Technology, Legal Tech'}
Nexlaw Partners	{'category': '', 'description': 'Business and technology advisors and consultants to the legal industry', 'tags': 'Consulting, CRM, Information Technology, Legal, Legal Tech'}
OOO SKB	{'category': '', 'description': 'OOO SKB specializes in the audit of information systems, security, research and development.', 'tags': 'Information Services, Legal Tech, Security'}
KeyVision PRO	{'category': '', 'description': 'KeyVision PRO is the work management platform legal teams use to run an efficient and profitable business.', 'tags': 'Legal Tech, Software'}
RealLegal	{'category': '', 'description': 'RealLegal provides transcript management tools to court reporting firms, freelance reporters, official reporters, courts, and law firms.', 'tags': 'Consulting, Information Technology, Legal, Legal Tech, Software'}
Law Offices Of Barry K. Rothman	{'category': '', 'description': 'Law Offices of Barry K. Rothman is a full-service entertainment & business law firm.', 'tags': 'Law Enforcement, Legal Tech, Retail'}
Legalr	{'category': '', 'description': 'Legalr is a legal database developing a platform that allows anyone to easily access and understand the laws that affect their lives.', 'tags': 'Database, Information Technology, Legal, Legal Tech'}
Weisberg Friedman & Klapisch	{'category': '', 'description': 'Weisberg Friedman & Klapisch is a Consultation agency & law firm company.', 'tags': 'Consulting, Legal, Legal Tech'}
Pope mcglamry	{'category': '', 'description': 'Pope McGlamry is a Georgia-based civil litigation law firm committed to excellent legal representation and counsel.', 'tags': 'Law Enforcement, Legal, Legal Tech'}
Gepro Software Jurídico	{'category': '', 'description': 'Gepro Software Jurídico specializes in software development for the Brazilian legal market.', 'tags': 'B2B, B2C, Legal, Legal Tech, Software'}
Bungeni Consulting	{'category': '', 'description': 'Bungeni Consulting focuses on legal and legislative space, and application of semantic technologies to laws and legal information.', 'tags': 'Legal, Legal Tech, Management Consulting'}
Peters & Peters	{'category': '', 'description': 'Peters & Peters is a law firm that specializes in commercial disputes, corporate fraud, corruption, mutual legal assistance and city crime.', 'tags': 'Law Enforcement, Legal, Legal Tech'}
Indenizar	{'category': '', 'description': 'Law tech', 'tags': 'Advice, Air Transportation, Consulting, Legal, Legal Tech'}
Blackmere Consulting	{'category': '', 'description': 'Blackmere Consulting is a leader in Technical Executive Recruiting dedicated to Cybersecurity and Engineering.', 'tags': 'Consulting, Corporate Training, Cyber Security, Information Technology, Legal, Legal Tech, Recruiting, Risk Management, Staffing Agency'}
Makowski Legal Group	{'category': '', 'description': 'Makowski Legal Group is to provide highly skilled, qualified and aggressive legal representation to people.', 'tags': 'Legal, Legal Tech, Professional Services'}
Curtin & Heefner	{'category': '', 'description': 'Curtin & Heefner is a law firm that provides environmental, litigation, employment and labor services.', 'tags': 'Law Enforcement, Legal Tech, Professional Services'}
EDOA	{'category': '', 'description': 'Edoor is a professional group that provides organization and personnel consulting.', 'tags': 'Freelance, Legal Tech, Recruiting'}
Grinm Advanced Materials	{'category': '', 'description': 'Grinm Advanced Materials operates in the fine materials industry.', 'tags': 'Legal Tech, Semiconductor'}
Lovelace Killen	{'category': '', 'description': 'Lovelace Killen is a full service law firm committed to the Johnson and Tarrant County communities.', 'tags': 'Legal, Legal Tech, Real Estate'}
Vance and Larson Law Firm	{'category': '', 'description': 'Vance & Larson Law Firm is a law practice firm that specializes in Brain Injury, Car Accidents, Workers Compensation & Personal Injury.', 'tags': 'Legal, Legal Tech, Professional Services'}
Intelivix	{'category': '', 'description': 'Intelivix develops smart solutions that help legal departments deal with and analyze data.', 'tags': 'Artificial Intelligence, Database, Information Technology, Legal, Legal Tech, Software'}
Harrison and Held	{'category': '', 'description': 'Harrison & Held is an independent boutique firm that provides exceptional service and value to our clients by focusing on core strengths.', 'tags': 'Commercial, Legal Tech, Wealth Management'}
Puritas Springs Software	{'category': '', 'description': 'Puritas Springs Software is a software company that specializes in the development of reasonably-priced legal and tax software .', 'tags': 'Consumer Software, Legal Tech, Software'}
Ajudici	{'category': '', 'description': 'Ajudici is a Brazilian legal SQL database, allowing companies to access the information they need in the simplest form.', 'tags': 'Database, Legal, Legal Tech'}
RenterLove	{'category': '', 'description': 'RenterLove helps tenants settle disputes with their former landlords', 'tags': 'Legal Tech'}
D'acordo Mediações	{'category': '', 'description': "D'acordo Mediações connect clients and companies to help build deals through online negotiation and mediation.", 'tags': 'Information Services, Information Technology, Legal, Legal Tech, Software'}
Fowler Hein Cheatwood & Williams	{'category': '', 'description': 'Fowler Hein Cheatwood & Williams is a law enforcement which provides Tax attorney located in Atlanta.', 'tags': 'Law Enforcement, Legal, Legal Tech'}
Malgueiro Campos Advocacia	{'category': '', 'description': 'The Malgueiro Campos Advocacia was born with a vocation: to be alongside entrepreneurs, startups, small and medium companies.', 'tags': 'Advice, Business Development, Consulting, Legal, Legal Tech'}
Makaira	{'category': '', 'description': 'Macaira is a public affairs consulting company.', 'tags': 'Environmental Consulting, Legal Tech, Management Consulting'}
Soloway Wright	{'category': '', 'description': 'Soloway Wright is a community-based law firm that offers real estate, business, finance and securities.', 'tags': 'Commercial, Legal, Legal Tech'}
iProcessum	{'category': '', 'description': 'IProcessum is a legal software for lawyers and law firms who want more efficiency on a day to day basis.', 'tags': 'Legal, Legal Tech, Software, Task Management'}
Millennium International Patent Law Firm	{'category': '', 'description': 'Millennium International Patent Law Firm provides legal acquisition and technical transaction services.', 'tags': 'Law Enforcement, Legal Tech'}
SL DESK, Smart Legal Solutions	{'category': '', 'description': 'SaaS', 'tags': 'Legal Tech'}
Callahan & Blaine	{'category': '', 'description': "Callahan & Blaine is a California's premier litigation firm.", 'tags': 'Law Enforcement, Legal Tech, Professional Services'}
Tomaz	{'category': '', 'description': 'Tomaz is a tool that helps consumers find their rights.', 'tags': 'Advice, Consumer, Legal, Legal Tech, Peer to Peer'}
Plougmann Vingtoft	{'category': '', 'description': 'Plougmann Vingtoft offers advice and consulting services to companies for business development within intellectual property rights (IPR).', 'tags': 'Consulting, Intellectual Property, Legal Tech'}
Rooney Law Firm	{'category': '', 'description': 'Rooney Law Firm is a law firm.', 'tags': 'Law Enforcement, Legal, Legal Tech'}
Legacy Network	{'category': '', 'description': 'Legacy is a blockchain-based application allowing people to easily distribute assets.', 'tags': 'Blockchain, Cryptocurrency, Insurance, InsurTech, Legal Tech'}
Keystone Legal	{'category': '', 'description': 'Keystone Legal is a provider of innovative and effective ‘After The Event’ and ‘Legal Expenses Insurance.', 'tags': 'Legal, Legal Tech'}
Jiangsu Zhongtian Technology	{'category': '', 'description': 'Jiangsu Zhongtian Technology Co., Ltd. manufactures and markets optic cables, optic fibers, electric cable materials and accessories.', 'tags': 'Communication Hardware, Hardware, Legal Tech, Manufacturing'}
Apptorney	{'category': '', 'description': 'Apptorney is a legal information platform in Zambia.', 'tags': 'Information Services, Legal, Legal Tech'}
contratabien.com	{'category': '', 'description': 'Contratabien.com is a HRM online platform in Latam.', 'tags': 'Human Resources, Legal Tech'}
WikiProp	{'category': '', 'description': 'WikiProp is a free website that makes it easy for people to read & understand laws.', 'tags': 'Education, GovTech, Legal Tech'}
Gestion Legal Colombia	{'category': '', 'description': 'GLC Consultores is a law office based in Bogota.', 'tags': 'Accounting, Consulting, Information Technology, Legal, Legal Tech'}
Rangefindr	{'category': '', 'description': 'Rangefindr is a Canadian company that offers researching criminal sentencing ranges.', 'tags': 'Big Data, Legal, Legal Tech'}
Dokument 24	{'category': '', 'description': 'Dokument 24 udarbejder juridiske dokumenter online - Jura 24 timer i døgnet.', 'tags': 'Legal Tech'}
Privacy Control Center	{'category': '', 'description': 'Privacy Control Center is a userfriendly platform to manage your GDPR Compliancy', 'tags': 'Compliance, Legal Tech, Privacy'}
API Garant	{'category': '', 'description': 'API Garant provides professional legal support using modern information technology.', 'tags': 'Information Services, Information Technology, Legal Tech'}
Jacobowitz & Gubits	{'category': '', 'description': 'Jacobowitz & Gubits is a full-service law firm dedicated to helping clients receive the legal assistance they need.', 'tags': 'Law Enforcement, Legal, Legal Tech'}
Assist-Ant	{'category': '', 'description': 'Assist-Ant provides a platform online that offers analytics of smart texts.', 'tags': 'Analytics, Information Technology, Legal Tech, SaaS, Software, Text Analytics'}
Pelkey & Pelkey	{'category': '', 'description': 'Pelkey & Pelkey is a finest law practice firm located in Rochester.', 'tags': 'Legal, Legal Tech, Real Estate'}
Management Solutions Consulting	{'category': '', 'description': 'Management Solutions Consulting is an international consulting firm whose core mission is to deliver advisory services.', 'tags': 'Consulting, Legal Tech, Management Consulting'}
iPLAB Startups	{'category': '', 'description': 'iPLAB Startups is an organization that supports something new from an intellectual property perspective.', 'tags': 'Legal, Legal Tech'}
Nominandum	{'category': '', 'description': 'Empowering legal excellence with state-of-the-art technology.', 'tags': 'Information Technology, Legal Tech, Software'}
Lawdef	{'category': '', 'description': 'Lawdef is a tech driven online platform which deals in legal services like trademark registration, iso registartion, fssai registration, etc', 'tags': 'Legal, Legal Tech, Professional Services'}
Public Law	{'category': '', 'description': 'SaaS', 'tags': 'Internet, Legal Tech'}
Lawsome	{'category': '', 'description': 'Lawsome is a legal service company that designs customized solutions for companies, operations, and innovative projects.', 'tags': 'Legal, Legal Tech, Venture Capital'}
dpVUE .images	{'category': '', 'description': 'High-quality Stock photos', 'tags': 'Legal Tech, Photography'}
Steinfeld and Steinfeld	{'category': '', 'description': 'Steinfeld & Steinfeld is provides exceptional legal representation and client service in family law and bankruptcy.', 'tags': 'Law Enforcement, Legal, Legal Tech'}
Edgar Law Firm	{'category': '', 'description': 'Edgar Law Firm is a legal tech company that specializes in one-on-one attention with an attorney.', 'tags': 'Legal, Legal Tech, Professional Services'}
SECIB	{'category': '', 'description': 'SECIB provides management software and solutions for law firms.', 'tags': 'Consumer Software, Legal Tech, Software'}
Prisma Jurídico	{'category': '', 'description': 'Prisma Jurídico, is an online legal consulting specialized in contentious-administrative.', 'tags': 'Legal Tech'}
Shenzhen Asia Link Technology Development	{'category': '', 'description': 'Shenzhen Asia Link Technology Development offers financial technology services.', 'tags': 'Finance, Hardware, Legal Tech'}
Law Explorers	{'category': '', 'description': 'Law Explorers facilitates comprehension of the language and terminology of law.', 'tags': 'Consulting, Information Technology, Legal, Legal Tech'}
The Heir Hunters	{'category': '', 'description': 'The Heir Hunters offer a claims service where we aim to undercut the fees of any of the recognised Heir Hunting firms in the UK.', 'tags': 'Legal Tech'}
Lawfully	{'category': '', 'description': 'Lawfully is a legal tech company that specializes in US immigration law using artificial intelligence.', 'tags': 'Legal, Legal Tech'}
Solucionare Logística Jurídica	{'category': '', 'description': 'Solucionare is a Judicial Information Specialist and acts with data processing and intelligence for the legal segment in Brazil.', 'tags': 'Advice, Consulting, Legal, Legal Tech'}
Intelectual Abogados	{'category': '', 'description': 'Abogados especializados en Propiedad Intelectual, Propiedad Industrial, Tecnologías, Derecho Sanitario, Salud, Delitos informáticos.', 'tags': 'Consulting, Legal, Legal Tech'}
KEY Discovery	{'category': '', 'description': 'Key Discovery is an independent Boston-based litigation support provider.', 'tags': 'Legal, Legal Tech'}
JusAPI	{'category': '', 'description': 'JusAPI offers solutions for technology and APIs of Artificial Intelligence for the legal sector.', 'tags': 'Artificial Intelligence, Developer APIs, Legal Tech, Software'}
LIRIS	{'category': '', 'description': 'LIRIS is a legal tech service development company.', 'tags': 'Legal, Legal Tech'}
Law Offices Of J Samuel Worley	{'category': '', 'description': 'Law Offices Of J Samuel Worley offers personalized and affordable expert legal aide to protect your rights and defend your record.', 'tags': 'Law Enforcement, Legal, Legal Tech'}
GDPRfolder.eu	{'category': '', 'description': 'GDPR made accessible to SMEs', 'tags': 'Legal Tech, SaaS'}
Protorae Law	{'category': '', 'description': 'Protorae Law is a business law firm.', 'tags': 'Law Enforcement, Legal Tech, Professional Services'}
Liscentrum Capital	{'category': '', 'description': 'Liscentrum Capital is a financial corporation investing in exclusively in litigation and arbitration.', 'tags': 'Legal, Legal Tech'}
Policastro Law Group	{'category': '', 'description': 'Policastro Law Group is a specialty law firm with decades of experience representing property and business owners.', 'tags': 'Law Enforcement, Legal, Legal Tech'}
Vision Legal Services	{'category': '', 'description': 'Vision Legal Services is a range of bespoke services to facilitate investments', 'tags': 'Legal, Legal Tech'}
SC Patents	{'category': '', 'description': 'SC Patents is a specialist mutual insurance company providing professional indemnity insurance to firms of patent and trade mark attorneys.', 'tags': 'Legal Tech'}
ALTON North America	{'category': '', 'description': 'US- Corporation.org is a service of the company ALTON, which has been based in Miami (Florida) since 2005.', 'tags': 'Legal Tech, Marketing, Media and Entertainment'}
Global Legal Data	{'category': '', 'description': 'Global Legal Data is a legal firm that specializes in the professional practice of information and communication technology law.', 'tags': 'Consulting, Legal, Legal Tech, Professional Services'}
AutenTIC	{'category': '', 'description': 'AutenTIC develops a software platform for legal services.', 'tags': 'Advice, Information Technology, Legal, Legal Tech, Software'}
Templars	{'category': '', 'description': 'Templars is a leading full-service law firm.', 'tags': 'Law Enforcement, Legal, Legal Tech'}
Fidus Law Chambers	{'category': '', 'description': 'Fidus Law Chambers is a boutique intellectual property law firm.', 'tags': 'Legal, Legal Tech'}
Choice Legal Group	{'category': '', 'description': 'Choice Legal Group is a full service law firm that consistently delivers timely, high-quality legal services in Florida and Texas.', 'tags': 'Legal, Legal Tech, Professional Services'}
Justice2People	{'category': '', 'description': 'Justice2People is a LegalTech organization designing and developing platform.', 'tags': 'Law Enforcement, Legal Tech'}
Cavalcante Advogados	{'category': '', 'description': 'Cavalcante Ramos Advogados is headquartered in the main business hub of the city of Rio de Janeiro.', 'tags': 'B2B, B2C, Consumer, Legal, Legal Tech'}
Visionary Legal Technologies	{'category': '', 'description': 'Visionary Legal Technologies is a software development and legal services company.', 'tags': 'Legal Tech, Software'}
Reductech	{'category': '', 'description': 'E-Discovery and Forensic Evidence Management Platform', 'tags': 'Ediscovery, Legal Tech, Software'}
Athelstan	{'category': '', 'description': 'Litigation Predictive Analytics and Funding for Legal Cases', 'tags': 'Legal Tech'}
Gallo & Iacovangelo	{'category': '', 'description': 'Gallo & Iacovangelo is a full-service law firm uniquely qualified to represent you in a variety of practice areas.', 'tags': 'Law Enforcement, Legal, Legal Tech'}
Sallah Astarita and Cox	{'category': '', 'description': 'Sallah Astarita & Cox is a boutique law firm focusing on securities regulatory matters, broker-dealer and investment advisor regulation.', 'tags': 'Law Enforcement, Legal, Legal Tech'}
Vertex Legal App	{'category': '', 'description': "Vertex is the new era in law firm's services.", 'tags': 'Apps, Consulting, Legal, Legal Tech, Mobile Apps'}
Audley Clarke Solicitors	{'category': '', 'description': 'Audley Clarke specialise in volume litigation in the financial services and other sectors.', 'tags': 'Legal, Legal Tech'}
EXPO	{'category': '', 'description': 'Connect local lawyers with users in real-time', 'tags': 'Apps, iOS, Legal, Legal Tech'}
Third Dog Software	{'category': '', 'description': 'Expert software due diligence and technical services for clients involved in M&A for all technology stacks', 'tags': 'Consulting, Information Technology, Legal Tech, Software'}
Carofano Law	{'category': '', 'description': 'Carofano Law is a law firm.', 'tags': 'Law Enforcement, Legal, Legal Tech'}
Reviewsolicitors	{'category': '', 'description': 'ReviewSolicitors is an online review platform that allows users to post feedback on the services received from law firms.', 'tags': 'Law Enforcement, Legal, Legal Tech'}
Kwick Soft Solutions	{'category': '', 'description': 'Kwick Soft Solutions provides total evidence management and law enforcement related products and solutions.', 'tags': 'Law Enforcement, Legal Tech'}
Carman And Bevington	{'category': '', 'description': 'Carman And Bevington is a law firm focused on the insurance industry.', 'tags': 'Law Enforcement, Legal, Legal Tech'}
Fallco	{'category': '', 'description': 'Fallco provides softwares for legal professionals that covers financial services, securities procedure, and judicial goods among others.', 'tags': 'Financial Services, Legal Tech, Software'}
JusticeBot	{'category': '', 'description': 'JusticeBot provides legal procedure information in a simplified manner and connecting people with legal service providers.', 'tags': 'Law Enforcement, Legal Tech'}
Beau Walker - Marketing Scientist	{'category': '', 'description': 'Beau Walker - Marketing Scientist provides legal advice on marketing matters.', 'tags': 'Advice, Consulting, Legal, Legal Tech, Marketing'}
HELP ME	{'category': '', 'description': 'HELP ME is a law firm that provides legal internet services.', 'tags': 'Internet, Legal Tech, Payments'}
Case Law Search	{'category': '', 'description': 'Case Law Search is to provide you with a high quality research tool.', 'tags': 'Analytics, Consulting, Information Technology, Legal, Legal Tech'}
Beliveau Law Group	{'category': '', 'description': 'Beliveau Law Group provides legal services.', 'tags': 'Law Enforcement, Legal, Legal Tech'}
Whiting Consulting	{'category': '', 'description': 'Whiting Consulting is a boutique recruiting firm that provides talent acquisition and recruitment services.', 'tags': 'Consulting, Legal Tech, Recruiting'}
Az Justice Center	{'category': '', 'description': 'Az Justice Center is a legal services company that specializes in the life of each person served by helping them resolve legal problems.', 'tags': 'Legal, Legal Tech, Public Safety'}
The Pacific Law Group	{'category': '', 'description': 'The Pacific Law Group provides excellent legal services at reasonable rates for their local, mainland, and international clients.', 'tags': 'Law Enforcement, Legal, Legal Tech'}
Hoffberg & Associates	{'category': '', 'description': 'Hoffberg & Associates is a legal tech company located in New York.', 'tags': 'Law Enforcement, Legal, Legal Tech'}
Reyes & Reyes Law Firm	{'category': '', 'description': 'Reyes and Reyes Law Firm is a family of lawyers dedicated to fighting for your social security disability benefits.', 'tags': 'Law Enforcement, Legal, Legal Tech'}
Nomad Being	{'category': '', 'description': 'Nomadbeing.com helps enabling nomadic entrepreneurs through company registration & operational support services.', 'tags': 'B2B, Legal Tech, Service Industry'}
Mrv Marketing.	{'category': '', 'description': 'Mrv Marketing. is a information services and electronics company.', 'tags': 'Electronics, Information Services, Legal Tech'}
Hozelito	{'category': '', 'description': 'Hozelito is a tool that enables users to create, edit, sign, and collaborate on legal documents and contracts.', 'tags': 'Document Management, Information Technology, Legal Tech'}
Aamicus	{'category': '', 'description': 'Is a web-based platform that improves access to criminal justice in the UK', 'tags': 'Artificial Intelligence, Legal, Legal Tech'}
Budde Schou	{'category': '', 'description': 'Budde Schou is a full-service IP firm with comprehensive expertise in all aspects of IP rights, & offer advice & assists, corporate clients.', 'tags': 'Intellectual Property, Legal, Legal Tech'}
Advocatenkantoren.nl	{'category': '', 'description': 'Advocatenkantoren.nl is an independent platform where individuals and entrepreneurs can find legal services from specialized lawyers.', 'tags': 'Legal, Legal Tech'}
Jonathan G Brill Law Firm	{'category': '', 'description': 'Jonathan G Brill Law Firm is a law firm dedicated to its clients.', 'tags': 'Law Enforcement, Legal Tech, Professional Services'}
Replacement-in-hearing	{'category': '', 'description': 'Simple Replacements for lawyers', 'tags': 'Consulting, Legal, Legal Tech, Subscription Service'}
Wetherington Law Firm, P.C.	{'category': '', 'description': 'Consulting, Law Firm', 'tags': 'Consulting, Law Enforcement, Legal, Legal Tech, Management Consulting'}
Alfavit	{'category': '', 'description': 'Alfavit offers verbal, website, medical, technical translation, legalization, documents apostilization, and notarization services.', 'tags': 'Document Preparation, Legal Tech, Translation Service'}
Metricson	{'category': '', 'description': 'Metricson is a law firm expert that provides comprehensive legal services to tech and innovative companies.', 'tags': 'Legal, Legal Tech, Privacy, Security, Venture Capital'}
Axon Partners	{'category': '', 'description': 'Reimagining legal services', 'tags': 'Legal, Legal Tech'}
LT42	{'category': '', 'description': 'Legal Tech Company', 'tags': 'Legal Tech'}
Środkowopomorska Rada Naczelnej Organizacji; Technicznej	{'category': '', 'description': 'Środkowopomorska offers training and courses for personal data protection and public procurement.', 'tags': 'Legal, Legal Tech, Training'}
Brandnsulting Group	{'category': '', 'description': 'Brand Consulting Group is a consulting company located in Wilton.', 'tags': 'Consulting, Legal Tech, Management Consulting'}
Egloff and Partner Services AG	{'category': '', 'description': 'Egloff & Partner Services AG provides comprehensive legal services includes legal advice & support in court and administrative proceedings.', 'tags': 'Legal, Legal Tech'}
Rehabilitation Services	{'category': '', 'description': 'Rehabilitation Services is a private action orientated organization.', 'tags': 'Health Care, Law Enforcement, Legal Tech'}
FlashPoint IP	{'category': '', 'description': 'FlashPoint IP is a leader among intellectual property firms in patent search, IP strategy & obtaining a patent in Israel and worldwide.', 'tags': 'Law Enforcement, Legal, Legal Tech'}
Oberholtzer & Filous	{'category': '', 'description': 'Oberholtzer & Filous is a legal tech company located in Medina.', 'tags': 'Government, Law Enforcement, Legal Tech'}
DiRiSo	{'category': '', 'description': 'DiRiSo is a legal tech company for legal problems for lawyers and law firms.', 'tags': 'Legal, Legal Tech, Software'}
ab asesores y administraciones	{'category': '', 'description': 'ab asesores y administraciones is a consulting company located in Marbella.', 'tags': 'Consulting, Legal Tech, Management Consulting'}
Ramseier Treuhand	{'category': '', 'description': 'Ramseier Treuhand is a fiduciary and audit company located in the Northwestern Switzerland region of Basel.', 'tags': 'Finance, Law Enforcement, Legal Tech'}
Jureca	{'category': '', 'description': 'Jureca is a digital platform that connects lawyers and litigants for legal services.', 'tags': 'Legal, Legal Tech'}
Renata Laterza Consultancy	{'category': '', 'description': 'Renata Laterza is a consulting firm specialized in providing relocation services and advice on immigration services.', 'tags': 'Advice, Consulting, Legal, Legal Tech, Travel'}
Aquarium | Legal Things	{'category': '', 'description': 'Aquarium | Legal Things connects people and companies to foster the ecosystem of legaltechs and socialtechs.', 'tags': 'Collaboration, Legal, Legal Tech, Social'}
FindResolution - Gestão Estratégica de Conflitos	{'category': '', 'description': 'FIND RESOLUTION offers creative and sustainable solutions.', 'tags': 'B2B, B2C, Consumer, Legal, Legal Tech'}
Processualle Lexjudix	{'category': '', 'description': 'Processualle Lexjudix specializes in legal technology.', 'tags': 'B2C, Consulting, CRM, Legal, Legal Tech'}
eConciliar	{'category': '', 'description': 'eConciliar is a virtual platform for conciliation of legal proceedings where the parties can negotiate agreements.', 'tags': 'Consulting, Legal, Legal Tech'}
About Innovation	{'category': '', 'description': 'About Innovation is an intelligent and collaborative solution that supports businesses in the life cycle of its IP portfolio.', 'tags': 'Business Development, Legal, Legal Tech'}
Ella Cheong Hong Kong	{'category': '', 'description': 'Ella Cheong Hong Kong is an intellectual property (IP) law firm.', 'tags': 'Intellectual Property, Legal, Legal Tech'}
AdvantageLaw, Inc.	{'category': '', 'description': "AdvantageLaw is the affordable, one-stop source for your law firm's business needs", 'tags': 'Legal, Legal Tech'}
PreEmpt.Me	{'category': '', 'description': 'Web app which reduces and ultimately prevents abusive calls, texts and chats', 'tags': 'Apps, Law Enforcement, Legal Tech, Personal Health, Social, Social Entrepreneurship, Subscription Service, Wellness'}
Total Translations	{'category': '', 'description': 'Total Translations, (TTI), the Premier Translation Company in Florida.', 'tags': 'Legal, Legal Tech, Translation Service'}
Arbitrate	{'category': '', 'description': 'Arbitrate is a legal startup, founded with the purpose of solving the delay in the trial of processes.', 'tags': 'Association, Consulting, Legal, Legal Tech, Management Consulting'}
MAIS JUSTIÇA	{'category': '', 'description': 'MAIS JUSTIÇA is a platform designed to assist ADVOCATES, LAWYERS and law firms in PROSPECTING and conquering NEW CLIENTS.', 'tags': 'B2B, Legal, Legal Tech, Software'}
Prima Veritas	{'category': '', 'description': 'PRIMA VERITAS is a legal firm that offers services for registration of trademark, copyright, invention and intellectual property.', 'tags': 'Intellectual Property, Legal, Legal Tech'}
Kazan Legal Center	{'category': '', 'description': 'Kazan Legal Center provides a wide range of services in the field of legal and financial consulting.', 'tags': 'Legal, Legal Tech'}
Tsoromokos & Papadopoulos	{'category': '', 'description': 'Tsoromokos & Papadopoulos is a boutique law firm located in Astoria.', 'tags': 'Law Enforcement, Legal, Legal Tech'}
Sob Demanda	{'category': '', 'description': 'Sob Demanda connects lawyers, law students and law graduates who have chosen to continue their studies and not practice law.', 'tags': 'Content, Legal, Legal Tech, Online Forums, Social Network'}
Oliveira Advocacia e Consultoria Jurídica	{'category': '', 'description': 'Oliveira Advocacia e Consultoria Jurídica provides legal advice.', 'tags': 'B2B, B2C, Consumer, Legal, Legal Tech'}
Legal Business	{'category': '', 'description': 'Legal Business provides legal consultation services for digital technology-based companies.', 'tags': 'Advice, Business Development, Consulting, Legal, Legal Tech'}
Ottoni´s Consultoria	{'category': '', 'description': 'Ottoni´s Consultoria provides legal and accounting support services for its users to develop their businesses.', 'tags': 'Accounting, Advice, Consulting, Legal, Legal Tech'}
Correa Porto	{'category': '', 'description': 'Correa Porto provides legal advice to its clients.', 'tags': 'Advice, Consulting, Legal, Legal Tech, Management Consulting'}
Edraftly	{'category': '', 'description': 'Edrafly helps lawyers, chambers, firms and clients make informed decisions by promoting transparency within the legal profession.', 'tags': 'Consulting, Information Technology, Legal, Legal Tech, Software'}
LEGAL WIN CONSULTING LLP	{'category': '', 'description': "We offer a full range of Legal and Tax advisory to  Start-Up's, and High Net Worth Individuals and Private Clients.", 'tags': 'Consulting, Legal, Legal Tech'}
Dok.legal	{'category': '', 'description': "Dok.legal offers a software solution that helps in automating their clients' legal documents and processes.", 'tags': 'Legal, Legal Tech, Software'}
Flime	{'category': '', 'description': 'Flime provides payments and legal documents management services to freelancers and companies.', 'tags': 'FinTech, Legal Tech, Payments'}
awracle	{'category': ''}
CLAWS'	{'category': ''}
